Current Commit,Parent Commit,Commit Date,Type,sqale_index_current,sqale_index_parent,lines_current,lines_parent,Seniority,Commit,lines,cumulative_lines,sqale_index,cumulative_sqale_index
f79d9a322c6008e5fada1453aebfb56afc316cc8,f2ec89691236b59f54f9cf41bccd79a5853af36c,2017-12-05 21:05:10+01:00,Normal,34968,34968,338440,338426,0,1.0,14,14,0,0
fc48047586a8f92262f55d9d2bfb976325844b23,f79d9a322c6008e5fada1453aebfb56afc316cc8,2017-12-05 21:11:20+01:00,Normal,34968,34968,338462,338440,0,2.0,22,36,0,0
78247b80a8cbf1ebfb7a54624de7dc92e1a1f888,770b9ea77fb5e39d616e62b54c06755e6d4f4d36,2017-12-19 05:08:10-10:00,Normal,34950,34950,338499,338502,13,3.0,-3,33,0,0
4420761ea9457d386b2000cf9df5b2f6f88f8f91,78247b80a8cbf1ebfb7a54624de7dc92e1a1f888,2017-12-19 19:54:58+01:00,Normal,34950,34950,338518,338499,13,4.0,19,52,0,0
fc9eec7bb7d5e3e6426bb612277bfcecb943e8ac,a7a36bb4d8ef7f03c2df9e3279c8f488ab3641d1,2017-12-20 11:05:27-05:00,Normal,34950,34950,338517,338518,14,5.0,-1,51,0,0
c8152137400b5932578cd1788b79560c9772e56b,038ea4f8593618cf0f408f15f756f2145de0d40e,2017-12-27 18:38:30+01:00,Normal,34943,34930,338710,338687,21,6.0,23,74,13,13
1d00923848d504c6132019492b8d5a6cdf8261db,c8152137400b5932578cd1788b79560c9772e56b,2017-12-27 19:47:14+01:00,Normal,34945,34943,338718,338710,21,7.0,8,82,2,15
83a36ac49a98d5d8801ed8428612e9a56aeb8699,058d112ed2635873d415661bdf0fcc8752ec37c9,2017-12-28 21:07:29+01:00,Normal,34957,34957,338814,338814,23,8.0,0,82,0,15
51a00749e9d1814acfb6bf8732ecd21f18944083,9bc4d90d1a8c4d1dee54115a0995a7b6fca8635b,2017-12-30 18:05:15+01:00,Normal,34993,34993,338842,338842,24,9.0,0,82,0,15
c86e9b5847bc2853fc6a3fcfbf8daa56786d3210,ab7f4c330629f24f006a35729ee0d758711312fa,2018-01-02 17:54:10-05:00,Normal,35045,35045,339057,339057,28,10.0,0,82,0,15
8f8a93a9ae49fa807348f9f456b6635c8ebc5d0c,777f216d555496798a1e65fd899b0f8a0349aeca,2018-01-06 18:50:54+01:00,Normal,35027,35027,339143,339102,31,11.0,41,123,0,15
7c81b28ebcaebbc2e5bbca9a73427d81166ce3dc,762bd34c3699875d315d478b3efb090155beb743,2018-01-07 14:28:41+01:00,Normal,35027,35027,339144,339144,32,12.0,0,123,0,15
385e6fb352f3cb80d2f72838e08372cb392aaa45,b17c1d53fd7875dd0e3ffcffbfdeff348834b9b0,2018-01-12 19:06:15-05:00,Normal,34998,35003,339191,339192,38,13.0,-1,122,-5,10
7fbb1bd00d8a3e9a834de83d36ebcbff15c18938,afd50a301996484816022c9595acd026ad51f40d,2018-01-19 08:55:29+01:00,Normal,35047,35047,339342,339342,44,14.0,0,122,0,10
aad1833fa05eb3376dc614de4a17c82f5635f36c,37c17846ad6b02c6dca72e8087a279cca04a0c27,2018-01-20 20:48:01+01:00,Normal,35077,35077,339625,339584,45,15.0,41,163,0,10
950171d7b20a148a964281aed16aff3d2c734ab4,ff05de760cc4ef4c7f188e163c722ec3bc1f0cbf,2018-01-23 08:53:45-05:00,Normal,35077,35077,339614,339625,48,16.0,-11,152,0,10
b002a032f90b8cd228cfcee6c88cd238a8191cc0,3187c89d6f8c60ca7e78093d5b37e0709e71cea9,2018-01-27 11:12:11+01:00,Normal,35104,35104,339793,339762,52,17.0,31,183,0,10
f73f821143d5934780e3b76f90ff9a7110c509f7,92fe161e699e1d4e8377a7d6c0130f368f245a2f,2018-01-31 20:02:45-05:00,Normal,35110,35110,339975,339989,57,18.0,-14,169,0,10
9bcf73d788866bc93f8248cb2e9d601ecbc4b50c,9cd313fc2e1282c9e40df62c89825eb7796988b2,2018-02-01 09:29:46+01:00,Normal,35110,35110,339960,339975,57,19.0,-15,154,0,10
75e45a45e7d08bd26d9d97c6359654b5cbe6a77e,16c5a334ff3ad9d8b3cd1314562c7af20a2a7c7d,2018-02-02 08:47:32+01:00,Normal,35100,35110,339888,339983,58,20.0,-95,59,-10,0
34b52f85720280572c9e8fd2869f3485a367899b,47268242b071895dd269d97540e45dce646f675c,2018-02-07 08:27:47+01:00,Normal,35122,35122,340114,340113,63,21.0,1,60,0,0
61596f40ad42f5c96aafd10b8585b8ba5643c0cf,8116e588dbdd17171a322da589b691bdf01f7041,2018-02-26 08:54:55-05:00,Normal,35281,35281,341210,341212,82,22.0,-2,58,0,0
074a2f7f58cfab807ae72b09e634cad30a895369,5b589a47b9ac2c8bdd13ba837fea37991a1457b9,2018-02-26 18:23:31+01:00,Normal,35281,35281,341197,341212,82,23.0,-15,43,0,0
54f80430be4a9adf1fc00b4ca17547415fafc69b,3fb718f17d0684a2eabcf4af722e84ac4608c76f,2018-02-28 18:05:23+01:00,Normal,35281,35281,341511,341488,84,24.0,23,66,0,0
8b25d546b6113bd8db7e3627939d107ebd834fff,f0d6f01fbe171f4599fd13e34ccff0a5af653e90,2018-03-07 14:04:17-05:00,Normal,35281,35281,341543,341564,91,25.0,-21,45,0,0
c3a1337dfaa90baa58f0ecd647a595f7c57eb772,25b97ee1702e8950de9b9cc6fc551485b385cf0f,2018-03-12 11:22:57-04:00,Normal,35277,35277,341580,341580,96,26.0,0,45,0,0
acfc650f2a6e4a79e80237eabfa923ea3a05d709,22bcd3a1d88add6e4cf2c4451ede8d1ae142dedd,2018-03-13 19:06:40+01:00,Normal,35277,35277,341618,341602,97,27.0,16,61,0,0
feb683c4c2c5ecfb61e4cb490c3e357450c0c0e8,8f75984c263b89336cdf919c246a56ce49d07ddb,2018-03-14 10:00:07+01:00,Normal,35277,35277,341675,341657,98,28.0,18,79,0,0
ba3078c92de6ea3017441c7f503f36e52973ac6b,87dc0844a634360182bcb74d491508111ef8a652,2018-03-15 09:54:24-04:00,Normal,35277,35277,341693,341693,99,29.0,0,79,0,0
9421aee35e629f610ca739f13f7e37c1af27c1ac,47bb3b68ff67a29da308b42e7950ca46df74b52b,2018-03-15 20:57:23+01:00,Normal,35277,35277,341754,341698,99,30.0,56,135,0,0
362813d6287925b8f63f0b107c55a74d95f5825e,aeb8c381789ad93866223f8bd07d09ae5e2edd9e,2018-03-16 10:54:34+01:00,Normal,35285,35285,341816,341782,100,31.0,34,169,0,0
cede5111bbeea1f02a7d35941a4264c7ff95df0a,8d67c7cffdcd5fd0c5cb0b87cd699a05b461e58d,2018-03-19 17:35:16+01:00,Normal,35276,35276,341910,341849,103,32.0,61,230,0,0
6141c752fe7091d2197f5ac061300a9e0a36b09b,4f7467b6905482a5d826c2815dcf8c6dd332340d,2018-04-03 18:24:04+02:00,Normal,35260,35260,342379,342349,118,33.0,30,260,0,0
55cc26941a1eb6093bf9602e67a2b5fdf7e68683,6141c752fe7091d2197f5ac061300a9e0a36b09b,2018-04-03 19:36:12+02:00,Normal,35260,35260,342420,342379,118,34.0,41,301,0,0
816b386d41e58c6ae750f2e57b6614310886a61a,b2678468aee3526ec2d092a2f20b1d12b15ba12f,2018-04-03 22:21:47+02:00,Normal,35260,35260,342425,342420,119,35.0,5,306,0,0
0b66c3b442875627fa6daef4ac1e90900d74290b,e1f13f15512ece2d8ea8c7bf9f704ce4286c2ffa,2018-04-13 12:15:52+02:00,Normal,35294,35294,342806,342799,128,36.0,7,313,0,0
e0a3cfaca0088d82e625627a57e56b9f1a77b011,fdc936c9130cf4fb5d59869674b9a31cc79a7999,2018-04-17 12:50:43-04:00,Normal,35293,35293,342894,342898,132,37.0,-4,309,0,0
483cc1c430e038d7d16342f76761d18b989c3eed,30f8642f2e9f4ed64ddb09163e09c1ca073b935a,2018-04-28 19:39:45+02:00,Normal,35361,35361,343521,343520,143,38.0,1,310,0,0
35319bf12ccefe1911588493484160aa49208f89,1b7d524cfa7b7834af26c99407af66be6813938d,2018-05-12 19:37:42+02:00,Normal,35380,35380,343695,343695,157,39.0,0,310,0,0
4ab1f559e8d1264bcb20bb497988973194f5d8f2,cd242d185bda9269913d4d101a7f704204ec907d,2018-05-27 18:25:19-04:00,Normal,35486,35486,344306,344292,173,40.0,14,324,0,0
d0ad03cded64fc307b15668c81d0c65fd8486eff,8a6fcfdc77d84bd5cebf1e6a6dd65c64f9cb40b8,2018-05-31 10:38:42-04:00,Normal,35498,35498,344376,344376,176,41.0,0,324,0,0
e0d0fc0b14ccade00b30a7fbdb1c720ddd83bb71,acae1206800a7997e5f95f7df8043452301fa241,2018-06-08 12:05:22+02:00,Normal,35515,35515,344582,344582,184,42.0,0,324,0,0
4fb7bd834e97195633d44b27aa5e6f981709b626,63f90f55f30d599d601d729060cdb0ebd2abdeb8,2018-06-15 21:31:55-04:00,Normal,35550,35550,344752,344752,192,43.0,0,324,0,0
6dd4edb1b4f5441c5f543e29395039839c50d10b,e95008f2411d50929873f634c3e14ebac811fd28,2018-06-17 08:51:02+02:00,Normal,35558,35563,344829,344803,193,44.0,26,350,-5,-5
0e64e046a481c345358b1040df7c89480ad198e8,b49b59b02958354f9bb00f26aa468ce11b4815e1,2018-07-02 21:09:29+02:00,Normal,35579,35579,345400,345378,208,45.0,22,372,0,-5
d7d32964ef7b0951ecfd8565af2351ebfe1ea02b,17403f0a9b7167c635514c1e3d9d25ebad4b12e2,2018-07-04 12:57:29-04:00,Normal,35565,35561,345317,345315,210,46.0,2,374,4,-1
dd3b4707198f17557fdd9fe7a6fd9025b23dcaf3,312eb5cb11d09c0c41b2740e2e9aef838d60c8b5,2018-07-14 12:03:22+02:00,Normal,35633,35624,347702,347684,220,47.0,18,392,9,8
a73cf8110e6cccbf46bf77fd4ddce2df99df53ca,6e78e1054933c36a2e0fdf998db780c88bdef4a9,2018-07-18 11:54:15-04:00,Normal,35633,35633,347732,347732,224,48.0,0,392,0,8
5a017eef4ccf8c4818d85d3c8e7451998f921356,1a28dc3887e8d66d5e3ff08cf7fb0a6212b873e5,2018-07-22 08:47:55+02:00,Normal,35674,35674,347881,347879,228,49.0,2,394,0,8
ac25dd1f8d48accc765c05aebb47c427e51f3255,6429961418b0da70e915fcb61f4cf41977cf818a,2018-07-25 08:00:11+02:00,Normal,35678,35674,347893,347883,231,50.0,10,404,4,12
1a9cbf41a130def83a7e384955544d08be0fc148,d8e2be459f97f1773c7edf7d37de180139146176,2018-08-03 10:31:55+02:00,Normal,35723,35723,348519,348503,240,51.0,16,420,0,12
9fee229874367beafd532dad6d0f9ff9676ded0b,3767c7ff391d5f277e25bca38ef3730ddf9cea9c,2018-08-08 08:51:20+02:00,Normal,35746,35746,349002,348997,245,52.0,5,425,0,12
ac29fec1116953a70f055c45a0aef6a24477653e,49b679371fe9beddcd23a93b5fdbadea914f37f8,2018-08-20 22:16:27+02:00,Normal,35761,35761,349351,349351,258,53.0,0,425,0,12
39461a83c33f0cfe719d3b139413d1f5d1e75d5e,166dec84069c15ecb2bc3a5590f872febdc4709c,2018-08-29 10:00:15+02:00,Normal,35811,35811,349515,349504,266,54.0,11,436,0,12
e7a0a5c8b21f5ad1a0066bd0dfab84466b474e15,1b1f64ee5a78cc217fead52cbae23114502cf564,2018-09-13 22:12:21+02:00,Normal,35839,35853,349726,349789,282,55.0,-63,373,-14,-2
da92ec79621fc0bba671d8afa52b7f6884962fe5,f87f9c5f63f779edc74f286ccf88d13db96c44de,2018-09-16 12:45:34+02:00,Normal,35865,35865,349815,349813,284,56.0,2,375,0,-2
7b159df94235036a41ee93952ff83bbc95c1da3c,0192e9a976ea7018220ec607de63a641323404b1,2018-09-18 15:58:20-04:00,Normal,35870,35870,349847,349848,286,57.0,-1,374,0,-2
90d93a1b425c0e6e3d88afa9fff78790300e1e38,82f286cf6f198d37850d3c5df637b5665566a66b,2018-09-26 08:51:27+02:00,Normal,35893,35893,350183,350190,294,58.0,-7,367,0,-2
024abe5b82d95ee60cb18a77ebf841ad715467fa,51da347c32f5af1e8de4be77c15d6a35b58d4059,2018-09-26 20:18:48+02:00,Normal,35893,35893,350277,350182,294,59.0,95,462,0,-2
52fec5d18f46febedd461c47f3829750a2a7160b,1b49b792e9f0e6a5ae22f49f75586847e7e183bf,2018-10-11 11:43:16+02:00,Normal,35944,35944,350654,350656,309,60.0,-2,460,0,-2
a3052c35d165b493f1a8695eaad277f5028e7cf4,1e3cd5116367a15e2c9855dced062de885e1f0f0,2018-10-13 20:25:23+02:00,Normal,35940,35940,350663,350666,311,61.0,-3,457,0,-2
f2e2a1bd4be8ec7624b081488292b804777a526a,f07091a30fbac713a03d292ec1c901f0a7757440,2018-10-15 15:57:22+02:00,Normal,35940,35940,350678,350663,313,62.0,15,472,0,-2
328f5627ddfca3008dc5cf9f7da1ade0157ac74f,19126339f307e589f99259ab0176c4367a8055f0,2018-10-21 09:08:05+02:00,Normal,36007,36007,351015,351002,319,63.0,13,485,0,-2
641742528a8babbede92890bc0bef50a255c1bbb,8f90593e6f8197148c8f86e598bfef6792f3f4bf,2018-10-24 09:13:10-04:00,Normal,36026,36026,351067,351067,322,64.0,0,485,0,-2
58d1e9aa8ab505912389e7cd019a6f21785ad4bf,641742528a8babbede92890bc0bef50a255c1bbb,2018-10-24 09:17:59-04:00,Normal,36026,36026,351067,351067,322,65.0,0,485,0,-2
c6525bea9ec3d1d1e73585ca6e3116bb55afb336,9a88c6dd6aa84a1b35e585faa0058a0996cc7ed7,2018-10-25 19:39:42-04:00,Normal,36018,36018,351116,351077,324,66.0,39,524,0,-2
ff8020ed49571b0fece67d10d7398d5f57cbaa74,9886dffdf45873a5ce427eded9277f37d4a30ef1,2018-11-13 18:22:41-05:00,Normal,36095,36095,352105,352067,343,67.0,38,562,0,-2
d5f4ce9849b062cc788988f2600359dc3c2890cb,2e4776196d0e7519f2fb306e8aabadc6f2968866,2018-11-21 09:06:50+01:00,Normal,36231,36231,352736,352755,350,68.0,-19,543,0,-2
f091ea35150d95fc6732bbf0c27b971dd445509a,26c2a6ff883a213b4dcadf4411740aff866153ac,2018-11-26 19:45:05+01:00,Normal,36234,36234,352788,352768,355,69.0,20,563,0,-2
f9a33e3c3f4cfbff60522cd54455e78c96a9d2a4,ae180fa4b7f927a4aeae772975927c9888bb0cb0,2018-12-06 15:31:33-05:00,Normal,36303,36297,352937,352919,366,70.0,18,581,6,4
f0082b9a77b76e5fe10a49474d93c3f80a30b928,c5568340a525ab9c6898ed02c257394cc47285d7,2018-12-10 12:56:09+00:00,Normal,36314,36314,352991,352987,369,71.0,4,585,0,4
dd8ed64113947ed066b83e443053e389e8f77ebc,6fe9c45b725cd21eacbb50263bd3449e1a3edf17,2018-12-27 20:21:57+01:00,Normal,36387,36387,353452,353423,386,72.0,29,614,0,4
97844a3213359b79bfa63eee80aff22dc9a2d1be,b5fe97a34ea527d4254b58c2e828450e7c32157f,2019-01-03 20:10:33+01:00,Normal,36405,36405,353644,353644,393,73.0,0,614,0,4
e49ab7263763d653b3acaa88db9b6ebb4505d639,97844a3213359b79bfa63eee80aff22dc9a2d1be,2019-01-03 20:18:45+01:00,Normal,36405,36405,353644,353644,393,74.0,0,614,0,4
1508e71c5b056ba099097a849b13187dcbfa26a1,b181aba7dd24c73ec9923c39e35393b0487a5f47,2019-01-14 18:32:42-05:00,Normal,36511,36511,355507,355502,405,75.0,5,619,0,4
709a8b861de14204f0e13c9a0fbfd61c11b3565d,fe6d5a2da2ee0430a8fd7360816e6a3e4f843703,2019-01-18 16:50:06+01:00,Normal,36489,36489,355531,355515,408,76.0,16,635,0,4
f05c02c4b8d4e423e57d453c4bd699dc5ff7eaa7,7eb4db8732a3b491d4945a94a314842ba0ad8924,2019-01-19 13:31:15+01:00,Normal,36489,36489,355529,355529,409,77.0,0,635,0,4
5a5c77d55dc85c7e6cf910243257e408887f412a,738faf9da2a5cd03148a36375db80746c99c9623,2019-01-30 13:06:09+01:00,Normal,36475,36475,355681,355680,420,78.0,1,636,0,4
199025fa8816dde6c611193adbce1ba6c5a72c6b,c34c6d0a2fc6d9bc55fb2db94b9ed40141babb15,2019-02-02 15:36:20+01:00,Normal,36447,36447,355779,355779,423,79.0,0,636,0,4
85f924a9b92f5922376c1d3f1a4f1af1d957ef0e,3634560fa9ddb342c3a823b78cc63e7000ccabd8,2019-02-04 16:31:23+01:00,Normal,36451,36451,355819,355821,425,80.0,-2,634,0,4
21bb71ef0dcb86798edb0d8b21138bcc4b947590,10b0fd15763a8f4ac08633f7b4c091d6340faf3a,2019-02-06 19:25:04+01:00,Normal,36076,36076,354578,354657,427,81.0,-79,555,0,4
759a9b710c0e5a6009cfba406ff562919fa70ef0,af1434329fbdb295870301bd7e16e18fea95492e,2019-02-07 09:59:47+01:00,Normal,36070,36070,354523,354522,428,82.0,1,556,0,4
25829197bb94585e94695360065ac614aa9e6a56,22aab8662f0368b63f91f2526bdd0532524bc0fe,2019-02-08 21:38:30+01:00,Normal,36070,36070,354605,354605,430,83.0,0,556,0,4
7d5d20212c5b86aaa811deaa5eeb4212b615f2e8,543fc97407a932613d283c1e0bb47616cf8782e3,2019-02-12 20:10:02+01:00,Normal,36101,36101,354696,354697,433,84.0,-1,555,0,4
edec11ce86a1a0d9e4c5a2a0df6acaf655041c24,0104b5a41704430aaa1067da2281a86a83c8543a,2019-02-16 07:56:28+01:00,Normal,36096,36096,354744,354744,437,85.0,0,555,0,4
9ff18c08c32cf54d3c3a7a9e459d44711adba30f,21ff23bfeb4014bceaa3df27677fb68409c0634d,2019-02-21 10:52:51+01:00,Normal,36096,36096,354821,354760,442,86.0,61,616,0,4
463fe11bc8b2d068e447c5df677e7a31c2af7e03,52e9c753659ffeab67149fcf26b95c10cf137c40,2019-02-25 11:03:30+01:00,Normal,36104,36104,354903,354903,446,87.0,0,616,0,4
5c5d4d83dc22e8eede028b08b0dc9de78c235f7e,463fe11bc8b2d068e447c5df677e7a31c2af7e03,2019-02-25 11:25:15+01:00,Normal,36104,36104,354903,354903,446,88.0,0,616,0,4
b0799f5d86b6c0ccb1dcba6e0d2eee336f7f5928,5c5d4d83dc22e8eede028b08b0dc9de78c235f7e,2019-02-25 20:05:31+01:00,Normal,36104,36104,354903,354903,446,89.0,0,616,0,4
f69c7bbdceba43789bfba935dd8fa3daaa7f36c4,fe65918dca405644047b7dbc295d14535626a83a,2019-03-01 19:38:21+01:00,Normal,36147,36147,355110,355106,450,90.0,4,620,0,4
b435f82939edf70674856e0e1cd63973c2e0a1d1,8ec7ded3706fe66bf307ed339eb852d73f6d10d0,2019-03-03 19:33:48+01:00,Normal,36134,36134,355141,355141,452,91.0,0,620,0,4
d77657737fcf09a28bc7905be15974977439351a,9fd90c4088833855b1ae973e4a66cab09a26f3e6,2019-03-12 15:46:39+01:00,Normal,36168,36170,355150,355223,461,92.0,-73,547,-2,2
a57c783dd4e6dc73847081221827a1902eede88b,782d85b6dfa191e67c0f1d572641d8236c79174c,2019-03-14 13:16:48-04:00,Normal,36256,36256,355433,355431,463,93.0,2,549,0,2
258110d6cdea5050f8df0bbc9af3fcd9bd342d29,a57c783dd4e6dc73847081221827a1902eede88b,2019-03-14 19:42:01-04:00,Normal,36256,36256,355433,355433,464,94.0,0,549,0,2
c9888bc8ecb8943ef08090e3325dcbdac825eafc,418263c457636d3301f2068c47f09a0f42e15c52,2019-03-20 13:44:30+01:00,Normal,36258,36258,355796,355796,469,95.0,0,549,0,2
dc53f2135b341ef0b6203ecb0a1894cdbd174a9c,044cc544203fdcf2601ff200547ecae2e51a5db5,2019-03-25 08:39:11+01:00,Normal,36246,36246,356402,356402,474,96.0,0,549,0,2
2a431db0f5e91110b4fda05949de1f158a20ec5b,c4447ad231b6ba071a5295192faa41ff6494f14e,2019-03-27 08:24:05+01:00,Normal,36252,36252,356481,356468,476,97.0,13,562,0,2
9ab1d5559681d3adde4fcfc98a19a7396ed6a42e,398afba084679f1055926f6f91bd33fe124a92c5,2019-03-28 07:10:54+01:00,Normal,36167,36167,356292,356289,477,98.0,3,565,0,2
e449c3a832ff2a4e3fa83cec6909d0476ed14110,881362986a1ee8f650752de8471a895890b71f96,2019-03-28 10:00:12+01:00,Normal,36167,36167,356292,356292,477,99.0,0,565,0,2
881362986a1ee8f650752de8471a895890b71f96,9ab1d5559681d3adde4fcfc98a19a7396ed6a42e,2019-03-28 10:00:12+01:00,Normal,36167,36167,356292,356292,477,100.0,0,565,0,2
7cbcf2e2cbca1acfccfd973f746a9e6abfc0052e,93daed25a41b5cf2f7804d91630caa1cd0786a9a,2019-04-01 15:11:54+02:00,Normal,36176,36176,357793,357789,481,101.0,4,569,0,2
4cbe2b06ce580423c62b6e49969f7e24d57d63b8,7cbcf2e2cbca1acfccfd973f746a9e6abfc0052e,2019-04-02 09:10:11+02:00,Normal,36176,36176,357793,357793,482,102.0,0,569,0,2
e6588aa4e793b7f56f4cadbfa155b581e0efc59a,8bdb12c1d3829f0d8d42068892f7e8322eaa9dab,2019-04-03 08:26:05+02:00,Normal,36176,36176,357793,357793,483,103.0,0,569,0,2
5efaf078f7609a8c95045bcfdab0ba256b5449bf,755673e1bca7edb6bee7a958f40d9ae54d85d44c,2019-04-05 11:05:53+02:00,Normal,36176,36176,357808,357797,485,104.0,11,580,0,2
79065b55a70cd220820a260a1c54851b7be0615a,6b4e57d79f49b3dfb297505840663ee13d7cf500,2019-04-05 21:35:51+02:00,Normal,36176,36176,357875,357838,485,105.0,37,617,0,2
1afbc96a75bd1765a56054f57ea2d4b238af3f4d,9f1d78f85704cb118e9f22efd57518a3584aa4ae,2019-04-14 10:02:59+02:00,Normal,36197,36197,358002,357984,494,106.0,18,635,0,2
5f7991c42cff73b6278106d499d719b726f85ead,bfae195b0a2c8dae755610a7e23add5c6bc37b5e,2019-04-15 12:02:26+02:00,Normal,36186,36197,357932,358007,495,107.0,-75,560,-11,-9
654614b38e09de47e542c5b5d52c194e1d146a39,03db5fddfd0c76303ec83eb1cd91a6d2dc4441cb,2019-04-18 12:06:39+02:00,Normal,36207,36207,358131,358123,498,108.0,8,568,0,-9
753580ecd17de62fa8ab9cd43c4cd0b986f9e348,a14c0fda15db7e0eb982ac7b68d47b45fc95b4cb,2019-04-19 08:27:06+02:00,Normal,36267,36267,358158,358158,499,109.0,0,568,0,-9
12b7956fc3735101fcad597047b80b57efb5048a,49fb3f5f3ed8b37f2ae02d0fdc6980c4152c58e3,2019-04-19 11:40:04+02:00,Normal,36267,36267,358169,358165,499,110.0,4,572,0,-9
a41b09266dcdd01036d59d76fe926fe0386aaade,12b7956fc3735101fcad597047b80b57efb5048a,2019-04-19 20:34:20+02:00,Normal,36267,36267,358169,358169,499,111.0,0,572,0,-9
994a00eb70969e4fd8f7a30a95122e2f0411ff48,a41b09266dcdd01036d59d76fe926fe0386aaade,2019-04-21 12:17:05+02:00,Normal,36267,36267,358169,358169,501,112.0,0,572,0,-9
f8f0f92ed9f73a025de599bd1a4965f2cc2ebbba,0a01ca80d7f7f1922d0c515669d0e7afd3acff5a,2019-04-25 07:36:07+02:00,Normal,36272,36272,358208,358208,505,113.0,0,572,0,-9
5df3301aab9e1d1c386799263bef5cf013985c83,f8f0f92ed9f73a025de599bd1a4965f2cc2ebbba,2019-04-25 07:36:07+02:00,Normal,36272,36272,358208,358208,505,114.0,0,572,0,-9
85676979a4845fa9b586ec42d4ddbdb9f28b7cc8,8d76443aba863b75ad3b1392ca7e1d59bad84dc4,2019-04-25 15:45:00+02:00,Normal,36286,36286,358262,358262,505,115.0,0,572,0,-9
ed880d92b50c641c3e7f6e8ce5741085ffe1f8fb,0dd2308cf6f559a4f4b50edd7c005c7cf025d1aa,2019-04-29 10:38:17+02:00,Normal,36293,36287,358339,358325,509,116.0,14,586,6,-3
2106b983c433586925df12cdca72374829756e45,568eed9e79470b9ddf3e1b3bbad9123ada45eae8,2019-05-01 07:05:47+02:00,Normal,36344,36344,358483,358483,511,117.0,0,586,0,-3
9006189c0e80c12d1fc0357bf8f04c75d254b1ce,567b9928a3ad37e95b9ae17ec41342daa6968739,2019-05-03 10:00:06+02:00,Normal,36450,36450,358750,358766,513,118.0,-16,570,0,-3
8c5649bfb71f272d9fe27f61230f4cb925e72c47,e68361364906170db936d917ab5dd07262f537b6,2019-05-03 13:49:02+02:00,Normal,36450,36450,358751,358749,513,119.0,2,572,0,-3
ef9f2eb69c9396683cefa742bc7d0a0792090e8d,f9c1d1884eb3b5328901453389b2519149935a7c,2019-05-08 11:29:17+02:00,Normal,36447,36447,358867,358855,518,120.0,12,584,0,-3
30dd43884e8e5dfb3dfd7e31fc78fd569f15916a,f038214d917c982613f5a15db8dfe325b1f7479b,2019-05-08 14:41:16+02:00,Normal,36447,36447,358919,358919,518,121.0,0,584,0,-3
df28ebd6c89d68e781020a6a4e8405c0154e8e40,514104cf236c1039644b70c0c0f128cecd42b233,2019-05-21 08:21:35+02:00,Normal,36521,36521,359088,359088,531,122.0,0,584,0,-3
2007e11d7069b0f6ed673c7520ee7f480f07de68,a2c31e12da272acc76f3a3a0157fae9a7f6477ac,2019-05-23 08:39:16+02:00,Normal,36526,36526,359167,359167,533,123.0,0,584,0,-3
f8b8b00f0197e52f7a0986fae51462be174dbaea,2007e11d7069b0f6ed673c7520ee7f480f07de68,2019-05-23 20:33:37+02:00,Normal,36546,36526,359192,359167,533,124.0,25,609,20,17
85195dd23733312fa58a115490a38508a1f2bc0c,45edd746cc9d4eb0a3a1392f1256e4b9b179994c,2019-05-24 10:54:05+02:00,Normal,36552,36552,359232,359224,534,125.0,8,617,0,17
1d25354fb5f87d35968cd78b53d9560fd75f5b1a,85195dd23733312fa58a115490a38508a1f2bc0c,2019-05-24 11:05:51+02:00,Normal,36552,36552,359232,359232,534,126.0,0,617,0,17
8bdc7a6778ab3849c31ec77a997d07676f210419,aff61790a326f214f5ea608bac8298c3a8716b1b,2019-05-27 12:05:48+02:00,Normal,36553,36553,359246,359246,537,127.0,0,617,0,17
b6c4766f53cf00bcf63cc2aa8be977c8589d083e,5ec44973dc2add8ced1ba50659344b52cec845e5,2019-05-27 19:59:49+02:00,Normal,36553,36553,359245,359246,537,128.0,-1,616,0,17
f6075fb333bae29ee213b050e91eaadef75496dd,cc80979f011c72f8b4b5f35a5a36f049bc07bf0e,2019-05-31 07:38:48+02:00,Normal,36628,36614,359412,359387,541,129.0,25,641,14,31
cc80979f011c72f8b4b5f35a5a36f049bc07bf0e,e2de49ec2ea5827b36d0d4ec4f90b4ee0a003e93,2019-05-31 07:38:48+02:00,Normal,36614,36614,359387,359372,541,130.0,15,656,0,31
ea6e684f344e5c2ed5a2be1cf2420725c2f88405,85436473066aae5d793caeced010ea4f45da4e79,2019-05-31 16:19:11+02:00,Normal,36628,36628,359291,359412,541,131.0,-121,535,0,31
f66021f3f773023d0c61d2537d5dd1e5e1740537,ea6e684f344e5c2ed5a2be1cf2420725c2f88405,2019-05-31 18:11:51+02:00,Normal,36628,36628,359293,359291,541,132.0,2,537,0,31
5ab75adb900ca3fce50e65e60b11f2eb3ce9fd25,b27c9c953bce3aed205ebc378350ef027ebdd25b,2019-06-03 14:08:51+02:00,Normal,36631,36631,359352,359352,544,133.0,0,537,0,31
100ec901aebebe56b61f101af38a228414098dd5,5ab75adb900ca3fce50e65e60b11f2eb3ce9fd25,2019-06-03 14:08:51+02:00,Normal,36631,36631,359352,359352,544,134.0,0,537,0,31
1f81e2df69c0f62f9bd85bca5b3876a2d8229fde,b916c27f9a83c019ff85132712267508f126ca83,2019-06-05 06:57:44+02:00,Normal,36631,36631,359427,359427,546,135.0,0,537,0,31
3fb0a1a67f0ca3e03db59a876f87e8d0828872c4,d6ea4898c44f75a25bc0b7a60b54fd6dddc69eb5,2019-06-07 07:49:17+02:00,Normal,36680,36680,359552,359547,548,136.0,5,542,0,31
2e00119e397dd30d20723861a495d872886685c7,9e38ed0536c7dc598a6c2c1bb774d0a8db3cdddc,2019-06-12 09:43:03+02:00,Normal,36684,36684,359734,359731,553,137.0,3,545,0,31
198a0adef2fd794189cad7cfb80db7c14b8e28c3,2e00119e397dd30d20723861a495d872886685c7,2019-06-12 09:43:03+02:00,Normal,36684,36684,359733,359734,553,138.0,-1,544,0,31
b616f65855e5658a0272506ded1274516daa908d,198a0adef2fd794189cad7cfb80db7c14b8e28c3,2019-06-12 10:51:43+02:00,Normal,36686,36684,359739,359733,553,139.0,6,550,2,33
3dca8738cbbbb5674f795169e5ea25e2002f2d71,6fa71872aefb974c16f0c51db423d710ef54c467,2019-06-12 12:59:02+02:00,Normal,36676,36686,359713,359735,553,140.0,-22,528,-10,23
fc2536fe66c519b306f673672b795d16f87ed57d,fde9b7d35e4e185903cc14aa587ca870037941b1,2019-06-13 10:26:21+02:00,Normal,36676,36676,359754,359754,554,141.0,0,528,0,23
415e899dc46c2f8d667ff11d3e54eff759eaded4,87f5d07eededc86f8ce1797fdfca7d4903ee0edc,2019-06-15 10:29:02-07:00,Normal,36676,36676,359874,359869,556,142.0,5,533,0,23
b08a18f17ba53eb0bc7fd7993924f3d7f8ed5c52,6e8303d49ba55e7393c7ef5553b240ae0d2f0c00,2019-06-18 11:38:51+02:00,Normal,36676,36676,359874,359874,559,143.0,0,533,0,23
14d026cccb144c6877294ba4cd4e03ebf0842498,a7038adbd02c916315b16939b835f021c2ee8880,2019-06-19 10:44:53+02:00,Normal,36676,36676,359878,359874,560,144.0,4,537,0,23
7f19e3713598a37b0809b5434114140170d12e34,a415ce70bef6d91036b00dd2c8544aed7aeeaaed,2019-06-20 12:29:58+02:00,Normal,36734,36702,360661,360569,561,145.0,92,629,32,55
9aeac299490212c86952857f321812ae9df943da,7f19e3713598a37b0809b5434114140170d12e34,2019-06-20 14:04:36+02:00,Normal,36734,36734,360661,360661,561,146.0,0,629,0,55
a9179ab032cda80801e7f67ef20db5ee60989f21,2ef6f209f79b0bd27d53405f0d46bb9ab82b2a52,2019-06-21 12:00:42+02:00,Normal,36734,36734,360663,360663,562,147.0,0,629,0,55
19895e897c9aa620de7db4dfd2fb19774075b755,8590726a5dd3087d40b549580703cd8c74f3d7b1,2019-06-24 08:10:23+02:00,Normal,36704,36704,360727,360727,565,148.0,0,629,0,55
4305fbe8b11f44ab5d6759346488026c1e9677b2,26d16c07fdc4a297daca554afa6375c70d6d82a9,2019-06-27 15:09:28+02:00,Normal,36715,36715,360794,360794,568,149.0,0,629,0,55
8fc8c958a5840df48a2bda110c6f06656968b156,d54baf6970d7a7298807de361c2ca5f42be9f363,2019-06-30 20:35:05+02:00,Normal,36738,36738,360889,360889,571,150.0,0,629,0,55
30b3ee9d0b33bb440f9c73d1ce9e0e7303887a9f,8fc8c958a5840df48a2bda110c6f06656968b156,2019-07-01 06:57:27+02:00,Normal,36738,36738,360889,360889,572,151.0,0,629,0,55
fc41401f33045d2015dd92e735a13e5ee4af3afd,54d0f5e62f54c29a12dd96f44bacd810cbe03ac8,2019-07-01 07:48:45+02:00,Normal,36738,36738,360902,360902,572,152.0,0,629,0,55
868cd56f058ca203419ad0886353173b74c3bcf1,fc41401f33045d2015dd92e735a13e5ee4af3afd,2019-07-01 10:14:36+02:00,Normal,36738,36738,360902,360902,572,153.0,0,629,0,55
f226bdbf4e06aa8ca787e34b0c626965ac526f28,a5308514fb4bc5086c9a16a8a24a945eeebb073c,2019-07-03 10:48:02+02:00,Normal,36765,36765,361033,361029,574,154.0,4,633,0,55
8233144ca0c93b589b61a2ad0fb7c851f3356a3b,bc91f27a86090b4c688b56cd4e37f95eebe6e969,2019-07-08 14:19:46+02:00,Normal,36762,36762,361134,361135,579,155.0,-1,632,0,55
08e69cad9ccb18738b66388b0d0ee4660470710e,febe136d4c3310ec8901abecca3ea5ba2be3952c,2019-07-09 07:39:35+02:00,Normal,36815,36815,361267,361267,580,156.0,0,632,0,55
24e8f7f7d3063a3bbfe14774080bc89035b4a3e2,08e69cad9ccb18738b66388b0d0ee4660470710e,2019-07-09 13:38:11+02:00,Normal,36815,36815,361267,361267,580,157.0,0,632,0,55
7991111af12056ec9a856f35935d273526338c1f,ee6e93ec8727d0f5ed33190a3c354867669ed72f,2019-07-10 10:33:36+02:00,Normal,36815,36815,361364,361297,581,158.0,67,699,0,55
7a42cfcfdc94c1e7cd653f3140b9eb30492bae4f,8c5f9906c56ac72fc4f13218dd90bdf9bc8a248b,2019-07-11 13:40:36+02:00,Normal,36851,36843,361487,361485,582,159.0,2,701,8,63
70c2b90d958e60c2da803502f5f20eb59ef3299a,402e6d292fd8aa5dfd49166e80098122950053f7,2019-07-12 17:27:49+02:00,Normal,36851,36851,361501,361502,583,160.0,-1,700,0,63
858cfd74e958b63e81657e5a9fc5f751c19e8192,70c2b90d958e60c2da803502f5f20eb59ef3299a,2019-07-13 10:55:19+02:00,Normal,36851,36851,361502,361501,584,161.0,1,701,0,63
ad4e83a6d1c0a212fae751a3125dff6e28b2390a,fa65b90a96f27dced8cfa89126d28186b4c80fbf,2019-07-16 15:08:14+02:00,Normal,36851,36851,361534,361534,587,162.0,0,701,0,63
cf79f92abee2ff5fd4fdcc1a124129a9773805b8,ad4e83a6d1c0a212fae751a3125dff6e28b2390a,2019-07-16 16:56:44+02:00,Normal,36851,36851,361528,361534,587,163.0,-6,695,0,63
230d75f59c43b9731465c4ec92ad714e301637b8,a3417282ac0464a9a2d1d7685bcfef10feed2597,2019-07-18 12:56:25+02:00,Normal,36857,36857,361943,361943,589,164.0,0,695,0,63
fc1182af01c391ce33d7fcf51c756829c6a11d5b,a2e1c17f193f5017e1f6fac7d860f1f9e34d7892,2019-07-19 16:06:05+02:00,Normal,36873,36873,362002,362002,590,165.0,0,695,0,63
a2e1c17f193f5017e1f6fac7d860f1f9e34d7892,1fc2c70f7613e014a31771afa537439b28dd35fb,2019-07-19 16:06:05+02:00,Normal,36873,36873,362002,362002,590,166.0,0,695,0,63
842fd620ff42815dd7741a60e09005af11740395,9f11939dd1477981da2f3a5487d80101faa21230,2019-07-20 15:15:41+02:00,Normal,36873,36873,361989,362002,591,167.0,-13,682,0,63
8d52a525c806ab162efb236e3e93785be9585184,2ff517ccb6116c1be6338e6bdcf08a313defc5c7,2019-07-23 13:34:06+02:00,Normal,36868,36868,362004,362001,594,168.0,3,685,0,63
fed5e19369f456e41f0768f4fb92602af027a46d,d89053585e11e869efcc9debb1c311b47b5e20ea,2019-07-24 13:32:02+02:00,Normal,36862,36868,362003,362028,595,169.0,-25,660,-6,57
806ba19bbff311b7d567857ae61db6ff84af4a2c,1853383969a4c53bbeba998757c30410bd3df4bb,2019-07-25 20:45:55+02:00,Normal,36861,36862,362103,362100,596,170.0,3,663,-1,56
7deeabc7c7526786df6894429ce89a9c4b614086,4b78420d250df5e21763633871e486ee76728cc4,2019-08-01 09:24:54+02:00,Normal,36828,36828,362232,362208,603,171.0,24,687,0,56
ff111ea5e39cf774b3cd4237790d2bffd2826fb0,e4684220af058789a9d2673a3503d2f88d8aa94a,2019-08-01 12:06:32+02:00,Normal,36828,36828,362285,362265,603,172.0,20,707,0,56
d14fa04ab398e77e6f19b0453af4183b5e4cd14e,e8d0d2a5efc8012dcc8bf1809dec065ebde64c81,2019-08-02 07:09:37+02:00,Normal,36828,36828,362285,362285,604,173.0,0,707,0,56
1af469e67fd3928a4b01722d4706c066000014e9,4cf1f2f13ee0927d63b48d0c7d8a8f532e0c0a1e,2019-08-02 20:32:21+02:00,Normal,36835,36835,362440,362440,604,174.0,0,707,0,56
0e02e496cdc75741a789f8694f66e776bb8214f1,25f21bd2376603c8e233a0a0e5a726a0fdfdd33e,2019-08-05 14:16:25+02:00,Normal,36841,36841,362556,362534,607,175.0,22,729,0,56
05964b2198e53a8d66e34d83d9123e3051720b28,0e02e496cdc75741a789f8694f66e776bb8214f1,2019-08-05 14:16:35+02:00,Normal,36841,36841,362556,362556,607,176.0,0,729,0,56
c19ad2da4b573431843e5cead77f4139e29c77a0,efa1908f662c19038a944129c81462485c4a9fe8,2019-08-13 08:42:17+02:00,Normal,36880,36880,362729,362710,615,177.0,19,748,0,56
1f8382d34d54061eddc41df6994e20ee38c60907,0b8d911d280f033154bb43f3da0e72b6175aa708,2019-08-14 15:25:35+02:00,Normal,36885,36885,362781,362755,616,178.0,26,774,0,56
49aeabbf27637dbdb7a96d43b164a20c8c8ea70b,ac34fccdb900788c2e024ea61bbaf4be7a46cce1,2019-08-19 11:43:06+02:00,Normal,36907,36907,362958,362958,621,179.0,0,774,0,56
b1f669406ff82fcd5fed9f20be258944bd3b3bf9,33b9b23bbb6c373843ef184d24438c1bdff37c82,2019-08-23 10:43:08+02:00,Normal,36928,36928,363298,363303,625,180.0,-5,769,0,56
521308e575e4510ef4256f2ba2943a5e570c9328,b1f669406ff82fcd5fed9f20be258944bd3b3bf9,2019-08-23 10:43:08+02:00,Normal,36928,36928,363324,363298,625,181.0,26,795,0,56
92c72b68b759d0b12d90e029f03a98c6a8f661fe,06372a8d274d5a03f72078180ea355b9c7434fb1,2019-08-23 21:25:21+02:00,Normal,36928,36928,363324,363324,625,182.0,0,795,0,56
579909a13feb958f75d1d77e9995cef8f2b9c2a3,d0861fcb2dbb2e733a189115b546651a5042a327,2019-08-26 09:15:37+02:00,Normal,36935,36928,363383,363368,628,183.0,15,810,7,63
c7f656435cbf4feee3515ae67cfbe12d6bf791fb,a44d80f88e22eda24dacef48e368895ebea96635,2019-08-29 09:29:46+02:00,Normal,36962,36962,363601,363599,631,184.0,2,812,0,63
069bee7c1232458a0f13c2e30daa8df99dbd3680,c7f656435cbf4feee3515ae67cfbe12d6bf791fb,2019-08-29 09:40:34+02:00,Normal,36962,36962,363601,363601,631,185.0,0,812,0,63
d275fd04f3fbb1a6cfa2273feb6cb414ce143b8c,4137fc2efce2dde48340728b8006fc6d66b9e3a5,2019-08-29 11:56:12+02:00,Normal,36972,36972,363705,363707,631,186.0,-2,810,0,63
6201141b2ccfc54874cb43158daae0efd49afa23,03fa846c6ab6abb7948ed6ecc84f35e7b6244b54,2019-08-31 07:19:19+02:00,Normal,37006,37006,363938,363938,633,187.0,0,810,0,63
47f49adc11c0d39be3f41f92becc1f606c49d8ce,3f8ee58ccc5c55e62625ad797ddde05778fe1bec,2019-09-02 07:43:51+02:00,Normal,37006,37006,363938,363938,635,188.0,0,810,0,63
0d4529d314f5b804c4e856146f6641a73027a2c4,5931d2e96ae94b204d146b7f751e0e804da74953,2019-09-04 08:02:32+02:00,Normal,37008,37008,364012,364012,637,189.0,0,810,0,63
e2c6a0858d7d9ad85eda353076a5b46608b704a9,b93d786251513a5da102abc31f275ab3ee2850ed,2019-09-05 09:18:34+02:00,Normal,37069,37066,364477,364455,638,190.0,22,832,3,66
053ff7e9e65ce82bb7ee72bff3dcdb797e16dbb9,ed2d411aa84efc76baba3adf0d0f99df0e44ba57,2019-09-05 14:06:46+02:00,Normal,37069,37069,364477,364477,638,191.0,0,832,0,66
350123f38c2b6217c38d70bfbd924a9ba3df1289,053ff7e9e65ce82bb7ee72bff3dcdb797e16dbb9,2019-09-05 15:56:52+02:00,Normal,37069,37069,364477,364477,638,192.0,0,832,0,66
addabc492bdc0191ac95d59ec34b56b34086ebb9,6c379f1a1897a0e0b95531ea7d9806b17b22ff89,2019-09-06 11:53:54+02:00,Normal,37070,37070,364507,364508,639,193.0,-1,831,0,66
0f2f517298efbb204ac3ae284d2fbbaa5f70cd38,513f137cfd289ed598448e6d23e4e555ff056945,2019-09-10 11:54:25+02:00,Normal,37119,37119,364817,364817,643,194.0,0,831,0,66
32796826bb7bc5f6cdd9e8bd69be1c9eaa1e6cff,0f2f517298efbb204ac3ae284d2fbbaa5f70cd38,2019-09-10 12:00:56+02:00,Normal,37119,37119,364817,364817,643,195.0,0,831,0,66
416c584cabd62a13985f1569ccf019c8b351f0a5,32796826bb7bc5f6cdd9e8bd69be1c9eaa1e6cff,2019-09-10 12:01:00+02:00,Normal,37119,37119,364817,364817,643,196.0,0,831,0,66
b47bb4c4a74f926111bdad4a6daae14ceed6f2dd,416c584cabd62a13985f1569ccf019c8b351f0a5,2019-09-10 12:01:00+02:00,Normal,37119,37119,364774,364817,643,197.0,-43,788,0,66
3d716467a9f046c7af4fb62c13e6b975c06c135f,b47bb4c4a74f926111bdad4a6daae14ceed6f2dd,2019-09-10 12:01:00+02:00,Normal,37113,37119,364699,364774,643,198.0,-75,713,-6,60
81993b47eaac3cea1ebbc610a3a6b824f5195523,cb2be9d5d57c34a70f0c549b780183f8c73aec4b,2019-09-10 12:01:00+02:00,Normal,37113,37113,364622,364640,643,199.0,-18,695,0,60
f1894bae3071da4ee577fc40ae61491f3e03d82c,81993b47eaac3cea1ebbc610a3a6b824f5195523,2019-09-10 12:01:00+02:00,Normal,37109,37113,364478,364622,643,200.0,-144,551,-4,56
b61ea56789a5825bd2961a335cb82f65e09f1614,f1894bae3071da4ee577fc40ae61491f3e03d82c,2019-09-10 12:01:00+02:00,Normal,37109,37109,364362,364478,643,201.0,-116,435,0,56
d17be88afd5f5e1059491e10408ba239e2e99fe2,b61ea56789a5825bd2961a335cb82f65e09f1614,2019-09-10 12:01:00+02:00,Normal,37099,37109,364297,364362,643,202.0,-65,370,-10,46
0ddb4ebf7bfcc4730c80a772dd146a49ef6895f6,d17be88afd5f5e1059491e10408ba239e2e99fe2,2019-09-10 12:01:00+02:00,Normal,37099,37099,364259,364297,643,203.0,-38,332,0,46
9a2a12d415e6d224797b0779c5af03deb8c45b0a,0ddb4ebf7bfcc4730c80a772dd146a49ef6895f6,2019-09-10 12:01:00+02:00,Normal,37099,37099,364253,364259,643,204.0,-6,326,0,46
cb2be9d5d57c34a70f0c549b780183f8c73aec4b,3d716467a9f046c7af4fb62c13e6b975c06c135f,2019-09-10 12:01:00+02:00,Normal,37113,37113,364640,364699,643,205.0,-59,267,0,46
937ddaff55efbfb4a9560603bbc8c5b17d9e1364,241deed2590bcb1d8c45271d44c86eaedfb57119,2019-09-11 12:20:16+02:00,Normal,37102,37102,364304,364304,644,206.0,0,267,0,46
c8250ef361dcb4c7ed76632e4308c6db22da77d0,937ddaff55efbfb4a9560603bbc8c5b17d9e1364,2019-09-11 13:40:49+02:00,Normal,37102,37102,364322,364304,644,207.0,18,285,0,46
bd7e0f81f8590eadcb820c976ba03c9b75bbcad6,b8dff52f440adfb78b40e19ee8bff45373ca2501,2019-09-16 07:37:47+02:00,Normal,37102,37102,364322,364322,649,208.0,0,285,0,46
28e769dfe6a65bf604f5adc6a650ab47ba6b3bef,9d5a487f334a93de3fdcadba0caa09cbafa0d5d6,2019-09-23 08:17:58+02:00,Normal,37134,37134,364648,364648,656,209.0,0,285,0,46
343afa788080fb874bcd10eab1a1a2fede98c526,485f65b3c010c25b8d75d1b40156db0fa9d5ca57,2019-09-23 08:24:00+02:00,Normal,37134,37134,364718,364718,656,210.0,0,285,0,46
01104368ff77c788f95377e8aceb48772a42fb42,b31e63879eb5d9717e9f890401f7222e4f00c910,2019-09-24 10:37:22+02:00,Normal,37139,37139,364832,364856,657,211.0,-24,261,0,46
bc46e386c7aa496642d3ffc9e4f56ae5a46417a7,3f141719a198983a41840e3c2ea542f87c92e4c1,2019-09-24 13:53:59+02:00,Normal,37139,37139,364832,364832,657,212.0,0,261,0,46
aad46ee274b0e294ac055cc199e6595de4ef4164,bc46e386c7aa496642d3ffc9e4f56ae5a46417a7,2019-09-24 13:54:08+02:00,Normal,37139,37139,364832,364832,657,213.0,0,261,0,46
580e644f24f1c5ae5b94784fb73a9953a178fd26,566fca14b3e1406f918898de5bb2b2382a44edaf,2019-09-25 12:32:24+02:00,Normal,37139,37139,364836,364813,658,214.0,23,284,0,46
67e7dffe9543aff259f63c8f12d15642fe7be100,dc890bef5ad8e9fccce55f3e64af72103ea6e8c1,2019-10-01 14:46:10+02:00,Normal,37164,37164,365014,365014,664,215.0,0,284,0,46
0d4b40fe66040693074b5898c7938ea099910690,67e7dffe9543aff259f63c8f12d15642fe7be100,2019-10-01 17:35:55+02:00,Normal,37164,37164,365029,365014,664,216.0,15,299,0,46
6475e6318c970359a2f02798910a917229ee17d7,0d4b40fe66040693074b5898c7938ea099910690,2019-10-01 17:35:55+02:00,Normal,37164,37164,365035,365029,664,217.0,6,305,0,46
84322a29ce9b0940335f8ab3d60e55192bef1e50,54ea290e5bbd19d87bd8dba807738eeeaf01a362,2019-10-02 07:49:47+02:00,Normal,37164,37164,365073,365073,665,218.0,0,305,0,46
e1aa93280276c7197637a763344cb9740d0e91ff,17595407ca456dc2f0cf3ddb5878ff75615c94ff,2019-10-02 09:58:14+02:00,Normal,37164,37164,365084,365084,665,219.0,0,305,0,46
02ba48bc23618c558136d8a0a48349c0bb497dc9,7b3c06cd72e691ffd932ccce338701c37297a415,2019-10-02 13:07:14+02:00,Normal,37164,37164,365156,365157,665,220.0,-1,304,0,46
02c63b8f2ff48935c0fa2df5e0c8c1699d32b362,0b7378db1fdd7bfc7b78089811b3abb722c4ba95,2019-10-09 13:07:50+02:00,Normal,37155,37155,365207,365204,672,221.0,3,307,0,46
2a6f45e08e8cb8c7e5157915c378b453109424d2,9facc9002079d2713bb2591ca01f3aca0b678a00,2019-10-10 14:22:04+02:00,Normal,37162,37162,365242,365242,673,222.0,0,307,0,46
05186c03a30686f4898c1cb9acf4b8613035afcc,2839659b42ef80038152768b6cedae1016c59d90,2019-10-14 08:42:38+02:00,Normal,37136,37136,365362,365360,677,223.0,2,309,0,46
06d34aab7cfb1632a1538a243db81f24498525ff,05186c03a30686f4898c1cb9acf4b8613035afcc,2019-10-14 11:13:27+02:00,Normal,37141,37136,365407,365362,677,224.0,45,354,5,51
4a849b670130a6054b8ce0e04faed833dd407a2a,adfd920cc5f932b9cabc8061563088016a8dfe13,2019-10-15 20:55:49+02:00,Normal,37141,37141,365417,365416,678,225.0,1,355,0,51
1877ec18753947795b7821f8b9176bd7ea7c03a3,4a849b670130a6054b8ce0e04faed833dd407a2a,2019-10-15 21:27:22+02:00,Normal,37141,37141,365418,365417,678,226.0,1,356,0,51
5becb36a79a0c31c7cc9e76237239ebd0fdda18d,1877ec18753947795b7821f8b9176bd7ea7c03a3,2019-10-16 13:56:23+02:00,Normal,37141,37141,365418,365418,679,227.0,0,356,0,51
440603a4bc0dc4f0b489489e80dcbab0ca736d23,5becb36a79a0c31c7cc9e76237239ebd0fdda18d,2019-10-16 14:39:13+02:00,Normal,37141,37141,365418,365418,679,228.0,0,356,0,51
1c5ec221a44fc9ce1585fc1f94830957df4322e7,440603a4bc0dc4f0b489489e80dcbab0ca736d23,2019-10-16 16:33:43+02:00,Normal,37141,37141,365418,365418,679,229.0,0,356,0,51
187a64608d2a207dfc12fdd6816526e9550069b7,1c5ec221a44fc9ce1585fc1f94830957df4322e7,2019-10-16 18:40:48+02:00,Normal,37141,37141,365418,365418,679,230.0,0,356,0,51
bebf61de11e2ddd06902392d81ccaf005f5e31e4,ef4beafa2ce58a81a56ffd48a20a6153126b611a,2019-10-18 07:46:31+02:00,Normal,37141,37141,365479,365478,681,231.0,1,357,0,51
3a8af298b95ac689ab7aebfa3ed1c64b82df7b71,bebf61de11e2ddd06902392d81ccaf005f5e31e4,2019-10-18 07:46:31+02:00,Normal,37141,37141,365490,365479,681,232.0,11,368,0,51
2847d2c760438195c4c71ea9d3fded1ce116ea4e,909c59f290975ca419e11c294cec15d3fdb6177a,2019-10-22 15:34:19+02:00,Normal,37171,37171,365827,365822,685,233.0,5,373,0,51
e10ebf43e12c6e2998abd31ca898fd5998464927,6e9189c0807a8b4818e77c2d83618a788b2ba906,2019-10-23 15:07:06+02:00,Normal,37191,37191,365935,365935,686,234.0,0,373,0,51
25903e41fb45ce9cc80dc93bf4b51ea431dcb2b6,e10ebf43e12c6e2998abd31ca898fd5998464927,2019-10-23 15:26:04+02:00,Normal,37191,37191,365930,365935,686,235.0,-5,368,0,51
2a54ce72f95977fefe796e99c7bbf6cd366927f9,25903e41fb45ce9cc80dc93bf4b51ea431dcb2b6,2019-10-23 15:26:04+02:00,Normal,37191,37191,365930,365930,686,236.0,0,368,0,51
e645f27907da0098ee08455d9f1acec14b285f98,e83c300a3312995d46315616f4361dfa110c741b,2019-10-24 12:18:13+02:00,Normal,37191,37191,365968,365965,687,237.0,3,371,0,51
daa9415f78279855808134e1f40766f6c5f4bdbc,dbcd7b064e7278614f29fc45468d461e263d4da7,2019-10-25 11:22:03+02:00,Normal,37191,37191,366025,366025,688,238.0,0,371,0,51
bf7b3e2750e3392d112b34e076ee1a77c8adbe77,2f010795e690550c8c6f56b3924c0f629cacb33b,2019-10-29 14:28:05+01:00,Normal,37243,37243,366444,366444,692,239.0,0,371,0,51
a370dbd9543703677697e80701b5dbec8c8e7da7,c2c27867ef1d4ad32369f8cda42a6d72b262cae5,2019-10-30 16:17:20+01:00,Normal,37179,37179,366465,366465,693,240.0,0,371,0,51
a9bd01d363376d2e88f96cbf81bc6b77b0ff2bce,3cf907c20c4f4d94f649fbb93a006af5c61b30b8,2019-10-31 20:04:47+01:00,Normal,37182,37183,366493,366493,694,241.0,0,371,-1,50
126cfefce2b59900138f2bf1ef6ad966cddc55d4,2d38eb0ab9f78d68c083a5b78b1eca39027b279a,2019-11-04 08:20:22+01:00,Normal,37182,37182,366521,366521,698,242.0,0,371,0,50
e5cacb1f47cb3a2943bbc7685a630c84503b0d1b,cff6b14b273244dff7a9764391087a5c68b9324a,2019-11-04 10:20:30-08:00,Normal,37182,37182,366554,366554,698,243.0,0,371,0,50
a20ea33ca66bafd38bfce1a73221384b8aa37170,b9fe7f9294b1b4fc974c008adeb96e1375cdb0c6,2019-11-05 10:18:47+01:00,Normal,37182,37182,366557,366553,699,244.0,4,375,0,50
4c45b627f8c05aaa60f0989f5a41aefe8d107b57,e651b3095c950627b1eed1527f2bb011ddad03de,2019-11-06 12:49:42+01:00,Normal,37193,37193,366624,366627,700,245.0,-3,372,0,50
58c1acb1d6054dfec29d0f30b1033bae6ef62aec,7b915ba8e88cdf05225f2a9ae877eaf3c071547b,2019-11-07 15:30:14+01:00,Normal,37193,37193,366865,366865,701,246.0,0,372,0,50
08c0d8b16bb7e79074bc9c8ab4f0db97a94d336a,2282d9f2e5d08fc782087ebe97ab195303a6e79b,2019-11-11 11:51:39+01:00,Normal,37193,37193,366928,366928,705,247.0,0,372,0,50
30359496a3f3d9af0b02afc334710f7e24c74f5b,6a04e69e686cf417b469d7676f93c2e3a9c8d6a3,2019-11-12 14:37:59+01:00,Normal,37195,37195,366972,366972,706,248.0,0,372,0,50
b93a0e34d9b9b99d41103782b7e7aeabf47517e3,30359496a3f3d9af0b02afc334710f7e24c74f5b,2019-11-12 22:11:44+01:00,Normal,37195,37195,366972,366972,707,249.0,0,372,0,50
3b4b36fb1d6c9dad80dce8ec2dbf77d269f3d0e7,8be79984dce7d819879a6e594ca69c5f95a08378,2019-11-13 14:22:23+01:00,Normal,37195,37195,366977,366968,707,250.0,9,381,0,50
ca0d50f34ad14be2eca3067011c659ef0e66a0bc,3b4b36fb1d6c9dad80dce8ec2dbf77d269f3d0e7,2019-11-13 14:22:23+01:00,Normal,37195,37195,366976,366977,707,251.0,-1,380,0,50
6e99585c19290fb9bec502cac8210041fdb28484,ca0d50f34ad14be2eca3067011c659ef0e66a0bc,2019-11-13 16:33:25+01:00,Normal,37195,37195,366980,366976,707,252.0,4,384,0,50
4527d5db0f0a939439b9373f7a9a4eee3386afff,530dd193f2a1c791c703f3f961e2296cbb316bf9,2019-11-15 21:05:42+01:00,Normal,37212,37212,367145,367145,710,253.0,0,384,0,50
8685e764efd2957085762d9249e07794d9a58dcb,22a7a406c99f5340e05860fee95df9629cb516a9,2019-11-18 08:50:09+01:00,Normal,37212,37212,367155,367145,712,254.0,10,394,0,50
e9def97d1095efed15a109d82fe0498ebd56fa04,89abecc75d7eadab681f29be5237972c6c2f997b,2019-11-19 12:33:39+01:00,Normal,37254,37254,367506,367506,713,255.0,0,394,0,50
3e5b349535f011a51dc308898924786143000631,36453526d3e1a5829864f106d6baa0ebdb20537e,2019-11-20 20:35:36+01:00,Normal,37259,37259,367537,367537,714,256.0,0,394,0,50
a36f7ed6ac5b2529db7e13fd3754290484928b18,7742cc0c8f620f7b65b02b5018a5f7078325d467,2019-11-27 07:36:20+01:00,Normal,37259,37259,367709,367709,721,257.0,0,394,0,50
e8fcdaad5c428878d0a5d6ba820d957013f75595,86a0231e0a087d4b909f76223cc55d5bbb673930,2019-11-29 08:23:01+01:00,Normal,37268,37250,367823,367781,723,258.0,42,436,18,68
0107e3d1058f653f66032f7fd3a0bd61e96bf782,c33eb6dcd0c211f8f02b2976fe3b3463f0a54498,2019-12-02 07:57:19+01:00,Normal,37291,37268,367924,367822,726,259.0,102,538,23,91
39e39d0ac1b720e7460ec8ccf45926c78edb2047,0107e3d1058f653f66032f7fd3a0bd61e96bf782,2019-12-02 08:10:39+01:00,Normal,37291,37291,367924,367924,726,260.0,0,538,0,91
845042b3d9faaefef8855c2bab48bd9532cd00ca,a1f14ee3e5a2160c2eef1dad58a1da11be4b1531,2019-12-02 13:58:41+01:00,Normal,37285,37285,367962,367962,726,261.0,0,538,0,91
908c67e719a54b8b612cb7df732126f42350f3fa,65285d1e7dc72f10ba69ab53b6fe5eb6b9ce3123,2019-12-02 21:43:59+01:00,Normal,37285,37285,367952,367952,727,262.0,0,538,0,91
95ae1a9f8caf9c63c14c1a7c3e15594d3181b3ca,d83b585e5cc2b6dec49982670b86d6b4dd339342,2019-12-04 09:22:51+01:00,Normal,37290,37290,368020,368020,728,263.0,0,538,0,91
3930ec1bf275d17f1c36cd38b38114177b1d1565,1f62c008d1c983b4e5450a8764605aa6246e1cb4,2019-12-05 08:38:39+01:00,Normal,37292,37292,367999,367999,729,264.0,0,538,0,91
82a88d2f48e13ef5d472741d5ed1c183230cfe4c,f138e75910b1e541686c4dce3d8f467f6fc234cb,2019-12-06 09:32:51+01:00,Normal,37307,37307,368106,368090,730,265.0,16,554,0,91
f46452638885d89cacfca6831e0b9982c87b6527,663bb435deb1d6c407818dacfdcddd458e9b60c6,2019-12-09 11:12:06+01:00,Normal,37310,37310,368189,368181,733,266.0,8,562,0,91
d6505273cd889886caca57884fa79941b18c2ea6,4540842bc385a60cf32970a8b372b80d47704bca,2019-12-09 15:45:53+01:00,Normal,37320,37320,368264,368261,733,267.0,3,565,0,91
3fb7c12158a2402f0f80824f6778112071235803,09341856ed9008875c1cc883dc0c287670131458,2019-12-10 11:17:50+01:00,Normal,37325,37325,368281,368279,734,268.0,2,567,0,91
ec12c37384798093e359971c8980fe0c68d555bc,e703b93a656b78b9b444bb3a9980e305ed002a70,2019-12-11 10:07:41+01:00,Normal,37330,37330,368330,368330,735,269.0,0,567,0,91
5a2b9f0b546222e928df91310acb9cf363a6c920,5b1fbcef7a8bec991ebe7b2a18b5d5a95d72cb70,2019-12-18 10:36:22+01:00,Normal,37344,37344,368543,368543,742,270.0,0,567,0,91
50a69efb2e73ab8b3ef26042d4579e8ade950c37,ef3baf966d73c71480198d6194fa277ef7daa87d,2019-12-18 10:51:57+01:00,Normal,37344,37344,368543,368543,742,271.0,0,567,0,91
45bcc6feac68165eb3642d3c308c74b4828e679e,67ea35df52f2e29bafca8881e4f356934061644e,2019-12-23 12:17:56+01:00,Normal,37364,37364,368833,368818,747,272.0,15,582,0,91
22ce5d0031bd795ade081394043833e82046016c,5e00bd1f7717149573df9607b848297a520881d3,2019-12-23 23:28:59+01:00,Normal,37364,37364,368875,368833,748,273.0,42,624,0,91
5a68f024987e6d16c2626a31bf653a2edddea579,62727e65fbc409e02995c5f713cc20d4c504d043,2019-12-27 15:25:50+01:00,Normal,37364,37364,368901,368899,751,274.0,2,626,0,91
c159bacebaa256a7d171d00a3eb14c4ef8357f7c,2f565f84aca136d9cc4e4d061f3196ddf9358ab8,2019-12-31 12:09:50+01:00,Normal,37369,37369,368974,368976,755,275.0,-2,624,0,91
ef1286e3e3e2ea1a854b0169da2cefed0241903e,9762617a03f2bff93384604799572e4fdf4b00b4,2020-01-02 07:46:29+01:00,Normal,37369,37369,368970,368970,757,276.0,0,624,0,91
434a81d320d1352b7c5db49800a99d0b285eefed,ef1286e3e3e2ea1a854b0169da2cefed0241903e,2020-01-02 07:55:53+01:00,Normal,37369,37369,368970,368970,757,277.0,0,624,0,91
69331bb851c34f05bc77e9fc24020fe6908b9cd5,434a81d320d1352b7c5db49800a99d0b285eefed,2020-01-02 08:36:08+01:00,Normal,37369,37369,368970,368970,757,278.0,0,624,0,91
1960d55f8baa412b43546d15a8342554808fff57,e3d546a1d986f83d8698c32e13afd048b65d06eb,2020-01-03 07:47:04+01:00,Normal,37369,37369,369005,369005,758,279.0,0,624,0,91
0f843fdd5b9b2f2307148465cd60f4e1b2befbb4,495d7a1ddf3c8c83d49f099ee3599afbc28306fe,2020-01-04 20:49:11+01:00,Normal,37391,37381,369215,369199,759,280.0,16,640,10,101
8be477be5c1a4afc9ad00bb58a324f637e018c0f,2ea3fb3e6386c43f124b542e92b817dbc227c76b,2020-01-07 09:54:22+01:00,Normal,37379,37379,369259,369243,762,281.0,16,656,0,101
53d8646f799de7f92ab9defe9dc56c6125448102,979f61abd322507aafced9627702362e541ec34e,2020-01-08 08:05:43+01:00,Normal,37373,37373,369188,369161,763,282.0,27,683,0,101
6f7998adc784032f4b8918ca2eea27537ea4cbbe,8b3e714ecf409ed6c9628c3f2a4e033cbfa4253b,2020-01-11 19:47:36+01:00,Normal,37396,37396,369467,369449,766,283.0,18,701,0,101
59b4e99dd00b9c36d56055b889f96885995e4240,63e6ee1f996e16a1a6238fed16fdb28bce156bc6,2020-01-15 09:32:42+01:00,Normal,37395,37391,369509,369483,770,284.0,26,727,4,105
c5e373d48cbdd923575956fed477b63d66d9603f,b5a62bd17db0e28e6842111034fa6714d0701edb,2020-01-15 12:53:21+01:00,Normal,37395,37395,369527,369528,770,285.0,-1,726,0,105
d202846ced2f58d7a34ad80bfe2bde8a542a70b9,c5e373d48cbdd923575956fed477b63d66d9603f,2020-01-15 15:07:07+01:00,Normal,37395,37395,369528,369527,770,286.0,1,727,0,105
bf77669453b9e9f64291da6701fe06fd5ba47e29,7400da49a5d0ec5a087c3cf05e0b2d15048fc93f,2020-01-16 08:06:16+01:00,Normal,37392,37395,369577,369544,771,287.0,33,760,-3,102
266c853e10de50ce75af8be834647fda2c5fc2a0,d08d4f464ab11cc226d4e197c0f43e26a7fd2961,2020-01-16 14:34:54+01:00,Normal,37407,37404,369639,369621,771,288.0,18,778,3,105
7d8df4ad032c6241776c2b3ec6c76af9dd84fda3,c7b97ac3a7908dab0825f6bdb61b40f641306a8e,2020-01-18 20:07:25+01:00,Normal,37429,37429,369678,369678,773,289.0,0,778,0,105
f34be5294d8bd9530079525fb56e661816a63e20,a920c0b852371d7cae4aacd5c67b62fe3c4e2d55,2020-01-20 11:00:05+01:00,Normal,37429,37429,369708,369706,775,290.0,2,780,0,105
b423873cb7574a8088e32d3e23f4d01a99fefeb2,971a84d6af9de738be2a7a8344fa8c80671d1729,2020-01-23 10:28:36+01:00,Normal,37446,37444,369776,369748,778,291.0,28,808,2,107
551f644b950b0ecc589b3ca74a190d808b303922,d66d72f95655312c413d916add61a62928639514,2020-01-24 19:59:48+01:00,Normal,37505,37505,370024,370024,779,292.0,0,808,0,107
c00b863ac6e9f6dfb295d4fc5291726a1112c080,ab3cbd8b9a315911248227208630a020cedca08f,2020-01-27 12:21:02+01:00,Normal,37526,37526,370079,370079,782,293.0,0,808,0,107
e2fab0b6795f12a175ccdb412bb010f9d00c5a91,c9bf1910e2c1a72244dbd1e3dd9a3ff7215b8b4a,2020-01-28 13:01:08+01:00,Normal,37526,37526,370127,370127,783,294.0,0,808,0,107
2a6fc89018881c07e38f81989ff0c012e7539390,f791673537014c00b4b74d6449063e2a66986c1f,2020-01-29 09:02:23+01:00,Normal,37526,37526,370182,370182,784,295.0,0,808,0,107
0ac8ac8b0dece68072548900e992fc31493154c1,4ca5c565f4dc9e97845036e86416abc5cfde766c,2020-01-29 09:34:37+01:00,Normal,37534,37534,370201,370201,784,296.0,0,808,0,107
5978de2ec0787c8912349a72a7143c33f62b980b,0ac8ac8b0dece68072548900e992fc31493154c1,2020-01-29 09:35:18+01:00,Normal,37534,37534,370201,370201,784,297.0,0,808,0,107
b7a3a6c9ef0a89625881b47594120bca55fa2e49,a45c8d7ad04b73e33b6989c3ffa2b8c51ae3e83b,2020-01-29 12:09:20+01:00,Normal,37534,37534,370197,370200,784,298.0,-3,805,0,107
2e6dc72d834781a720f837817211c04980cce73d,c1b24718e05ea474955777d7bc4d9d5634560cd5,2020-01-31 20:33:48+01:00,Normal,37523,37523,370251,370238,786,299.0,13,818,0,107
a260001a2d3b2d9a7e872c24295e793bdbd10698,2e6dc72d834781a720f837817211c04980cce73d,2020-01-31 20:42:16+01:00,Normal,37523,37523,370255,370251,786,300.0,4,822,0,107
6b178a3e930f72069f3cda2e6a09d1b320fc09ec,5dabb6002ed773c150da4bd3aee756df75d218c2,2020-02-03 07:48:11+01:00,Normal,37522,37523,370283,370256,789,301.0,27,849,-1,106
dd9cd7923ed62a53e101ce2c3caea37e24d66c0a,75daea2fc24da1c987d4fd979adb31a2c5a29d22,2020-02-04 11:58:12+01:00,Normal,37517,37517,370321,370321,790,302.0,0,849,0,106
1d5fb35e6a23c0670f3a128802a1776c8c7deaa8,335c9c94acf263901fb023404408880245b0c4b4,2020-02-05 09:21:38+01:00,Normal,37512,37512,370267,370253,791,303.0,14,863,0,106
7fa1a93c6c8109010a6ff3f604fda83b604e0e97,de1924e0e7499535f05298c46d9983fd1640d4b4,2020-02-05 14:31:30+01:00,Normal,37514,37514,370314,370310,791,304.0,4,867,0,106
708c534e0badd5659df2c66d6934a34b3cc79e5b,fc4f45ebdccd87f140f39bebed897053c7f345c5,2020-02-08 17:23:35+01:00,Normal,37540,37540,370323,370323,794,305.0,0,867,0,106
932bd794b29c24536b6277b61175bd11ca9be234,708c534e0badd5659df2c66d6934a34b3cc79e5b,2020-02-10 08:14:58+01:00,Normal,37540,37540,370323,370323,796,306.0,0,867,0,106
7e8339748cc199b4a13513891d9ac4f1e4794588,932bd794b29c24536b6277b61175bd11ca9be234,2020-02-10 08:18:58+01:00,Normal,37540,37540,370323,370323,796,307.0,0,867,0,106
41ef143bd9d22f2fc09085b0a653bb86d6851067,6fba85b7660bc8ab9d9abf354d527f4f2f1b5883,2020-02-13 20:22:58+01:00,Normal,37542,37542,370477,370477,799,308.0,0,867,0,106
b330b918e979ea39a21d47b61172d112caf432c3,cd2d508707857b1f6b8d4b9f73cd3be9a5ca0a37,2020-02-14 13:16:17+01:00,Normal,37542,37542,370466,370469,800,309.0,-3,864,0,106
2a038521c4eabdc5f6d5026d3dd6d22868e329cd,cbb6531e5bef7ffe0c46d6c44d598d7bcdf9029e,2020-02-18 11:45:12+01:00,Normal,37562,37562,370642,370635,804,310.0,7,871,0,106
d270c10a723ca04e467e08d6d8b38ae392191f2d,73a34f3fa81bbc04cfac695ab8fcbd3a4e33d929,2020-02-19 09:36:19+01:00,Normal,37573,37574,370824,370813,805,311.0,11,882,-1,105
4261907ff360d79379f52e4179920817d3244c7c,1e858adf7fabdeb98f95503d30ed6769a08c44b2,2020-02-19 14:48:26+01:00,Normal,37562,37562,370932,370932,805,312.0,0,882,0,105
94d4bd3a091dd9ac265e14619576b1ee568653b1,84e35f4679622bf6cf7c1763bee3ce9af9c892ff,2020-02-24 14:21:50+01:00,Normal,37566,37566,370953,370953,810,313.0,0,882,0,105
667f784baab31f11d2469e5d22bbdc2390dbc030,fba5d3b6e63fe4a07b1aa133186f997eeebf9aeb,2020-02-26 12:00:52+01:00,Normal,37561,37561,370962,370962,812,314.0,0,882,0,105
a49c2b6bf098eb48c07641f60dba9be78c6cc92f,e65fea9292ffdeb9bb76062f6cb2a5ff514ae969,2020-02-29 20:35:11+01:00,Normal,37611,37611,371320,371320,815,315.0,0,882,0,105
7b8fa1653fde578ab3a496d9974ab1d4261b8b26,3bd29a8a973e2bb11b00666458344aeab5684a39,2020-03-03 11:25:37+01:00,Normal,37606,37606,371388,371348,818,316.0,40,922,0,105
aee0bebc2faf9c6de8211b05d5f1281dc016084f,a19505eb2ecd4a07ff39f3f66898e68b69d0e680,2020-03-03 11:25:37+01:00,Normal,37606,37606,371399,371399,818,317.0,0,922,0,105
a19505eb2ecd4a07ff39f3f66898e68b69d0e680,7b8fa1653fde578ab3a496d9974ab1d4261b8b26,2020-03-03 11:25:37+01:00,Normal,37606,37606,371399,371388,818,318.0,11,933,0,105
6695d29b1c1ce979725816295a26ecc64ae0e927,65ab4f9f03e70733df6afd9d8454ec3700155111,2020-03-04 09:04:50+01:00,Normal,37616,37616,371651,371575,819,319.0,76,1009,0,105
f37f9a0bf061fd0dfe4e45adb39157c3307ec8e2,6695d29b1c1ce979725816295a26ecc64ae0e927,2020-03-04 09:59:07+01:00,Normal,37616,37616,371651,371651,819,320.0,0,1009,0,105
43f8ba1c7c0a264b67224c62b48fcd0dfdaddec3,f37f9a0bf061fd0dfe4e45adb39157c3307ec8e2,2020-03-04 10:46:43+01:00,Normal,37616,37616,371651,371651,819,321.0,0,1009,0,105
1b3a900a6919f9ffcfe22fae738e49b71e798ee0,43f8ba1c7c0a264b67224c62b48fcd0dfdaddec3,2020-03-04 10:56:07+01:00,Normal,37616,37616,371651,371651,819,322.0,0,1009,0,105
6dea42febaae82084c2ca5fef25b9e535e6bd794,1b3a900a6919f9ffcfe22fae738e49b71e798ee0,2020-03-04 12:25:17+01:00,Normal,37616,37616,371684,371651,819,323.0,33,1042,0,105
5ca76baa729bbbe62f5c4a0fc4f89747dc999029,828e3b1335e2614d338a630fd5b5f88d38a6b5d2,2020-03-05 08:55:34+01:00,Normal,37616,37616,371704,371703,820,324.0,1,1043,0,105
30ca66eadd1135d220ae1f0570bb0244c26b9d29,08a6215d334f88f16707278e6003af59d13345b4,2020-03-06 11:52:49+01:00,Normal,37622,37622,371777,371777,821,325.0,0,1043,0,105
9358da704ea9ba55f22df912e47b54eb85d5c97e,a3917c323f503b6a632109eaf0ce71cf73bc0b85,2020-03-07 22:46:13+01:00,Normal,37622,37622,371780,371777,823,326.0,3,1046,0,105
a3917c323f503b6a632109eaf0ce71cf73bc0b85,e12fea24f06f8911ddc2af1d6cbfb1adb529c1f2,2020-03-07 22:46:13+01:00,Normal,37622,37622,371777,371777,823,327.0,0,1046,0,105
c48a7d3a8ac1f448ca2ccd9714526dfff2eebaf9,eb77e80de01e658541d4fcc3b0b38783ce4e6a7e,2020-03-10 07:55:31+01:00,Normal,37612,37612,371833,371833,825,328.0,0,1046,0,105
5da627a58f41d6854342e95a171a82f5b2309d52,d82d2d49d629f010da2c0d81b5927946d971ae72,2020-03-10 08:53:28+01:00,Normal,37612,37612,371833,371833,825,329.0,0,1046,0,105
5e17301f38d0a4f372d4d36762a464f5f4714ebd,5da627a58f41d6854342e95a171a82f5b2309d52,2020-03-10 08:54:45+01:00,Normal,37612,37612,371833,371833,825,330.0,0,1046,0,105
3c35825009540e222311d591c7330fa17dd76c99,e663f695fb282053b31f69ee2dcbc67ddacb9104,2020-03-11 14:38:27+01:00,Normal,37624,37624,371957,371957,826,331.0,0,1046,0,105
35c7fe8334621fe5f9f6e96e46cea369e620cae0,3c35825009540e222311d591c7330fa17dd76c99,2020-03-12 07:37:14+01:00,Normal,37632,37624,371966,371957,827,332.0,9,1055,8,113
7d8cdad6b704051bb69a47721913701349463ead,35c7fe8334621fe5f9f6e96e46cea369e620cae0,2020-03-12 07:37:14+01:00,Normal,37632,37632,371969,371966,827,333.0,3,1058,0,113
8725d04764e3528cbaefd0925501f8403d22ae3e,ccf32aca442feae4c765fb6133c418b4e387f428,2020-03-12 10:56:38+01:00,Normal,37632,37632,372003,372002,827,334.0,1,1059,0,113
e2417010daf697d5a58bc2057a24b7785c4cef03,dd704c670543edc4672cc6114fe3d8da0dfbed7a,2020-03-13 12:06:28+01:00,Normal,37627,37627,372004,371995,828,335.0,9,1068,0,113
5c8441a0b8787c14b45fb761550571baea48604e,ba4389a36b5fb1afce0cddb4e28233138b6612b7,2020-03-18 18:41:40+01:00,Normal,35292,35291,367241,367234,833,336.0,7,1075,1,114
3f7e4b16bf58f99c71570ba75dc97db8265071be,5c8441a0b8787c14b45fb761550571baea48604e,2020-03-18 18:41:40+01:00,Normal,35292,35292,367237,367241,833,337.0,-4,1071,0,114
6e026aec5fe24ebded360fbc40cff51ccb1f3901,fc0fa72ff4cdbf5861a366e31cb8bbacd44da22d,2020-03-19 09:42:04+01:00,Normal,35467,35467,368046,368036,834,338.0,10,1081,0,114
2117b7c12e555de48f452a4610a21a6f8c77a02b,53b6a466d89f972aa435fe7b5135e9b501ce68ee,2020-03-21 20:02:57+01:00,Normal,35473,35473,368154,368154,836,339.0,0,1081,0,114
aa21020218a2dcd29a03444ad2a77f03f085b04e,f1db2ca7328ff9f0f8b4db81699cc46ff5c8cc37,2020-03-24 08:52:21+01:00,Normal,35422,35422,368115,368115,839,340.0,0,1081,0,114
895f28f9cbed817c00ab68770433170d83132d90,27746ab28ac88fc213456e63302b408312d95122,2020-03-24 20:52:05+01:00,Normal,35425,35425,368179,368179,839,341.0,0,1081,0,114
ab5720ad80b48fac746021e826fe76d0869f9c02,66b06822d05ca1cf897745e7cb3c89adc53363ba,2020-03-25 13:12:32+01:00,Normal,35433,35433,368251,368256,840,342.0,-5,1076,0,114
195e0cb1709e96144ccbb9863ff8526f4c733f63,8aa71f4e8706b6b3e4e60aaffb29d004e1378ae3,2020-03-31 12:09:17+02:00,Normal,35474,35474,368411,368411,846,343.0,0,1076,0,114
3eaf6d67d01dd13baa7237153e7a6e371c56b336,195e0cb1709e96144ccbb9863ff8526f4c733f63,2020-03-31 18:27:44+02:00,Normal,35474,35474,368411,368411,846,344.0,0,1076,0,114
5c24c16e68868b33ea0bb30173403da51a078d2e,a7e4ff370cdb046b048b40e6e0d043cc6a91247c,2020-04-01 10:55:53+02:00,Normal,35474,35474,368415,368411,847,345.0,4,1080,0,114
69e2cd6fed40f3ecf767609b80ad31f288446e48,ad811335bdd57d65dddbc05375ec3a70b59c96fb,2020-04-07 09:48:52+02:00,Normal,35501,35501,368675,368675,853,346.0,0,1080,0,114
a4e4737cf36f3ba6f526587f2656cf4be64b91bf,69e2cd6fed40f3ecf767609b80ad31f288446e48,2020-04-07 09:48:52+02:00,Normal,35501,35501,368675,368675,853,347.0,0,1080,0,114
678f958ef972bf9be402332537149ca0884035ba,a4e4737cf36f3ba6f526587f2656cf4be64b91bf,2020-04-07 09:48:52+02:00,Normal,35501,35501,368675,368675,853,348.0,0,1080,0,114
cf21fc9bf010c71385dbead215d26151fb70d2ad,678f958ef972bf9be402332537149ca0884035ba,2020-04-07 10:54:19+02:00,Normal,35501,35501,368675,368675,853,349.0,0,1080,0,114
db6933a032c850153a688b6c977691b37ca02745,2e67e80fbe0accd5f256415ac28af8bd82eeaced,2020-04-08 10:43:38+02:00,Normal,35523,35511,368850,368819,854,350.0,31,1111,12,126
537b0c5edf0ce7b825a6bfb5b98c87b63c257674,94b32a20ef798768029651f0e8fcc07731a62a64,2020-04-08 20:06:31+02:00,Normal,35523,35523,368916,368916,854,351.0,0,1111,0,126
9cab261427731a49ff4a1bf32941fd46eead4724,8b7b19f6c93711658fe23cf647916cc02e16adff,2020-04-09 11:16:28+02:00,Normal,35527,35527,368935,368930,855,352.0,5,1116,0,126
e8d308892597e6abee5b94a77543a7ef7d34a655,f5ede1cb6da473166d22c04dcbd8240e2a0f223d,2020-04-10 11:54:14+02:00,Normal,35485,35485,368999,368998,856,353.0,1,1117,0,126
cc70a0343ef51ffcc0b1211dd6e7abedc4b43ea6,ee37d2070a985073bff3715448535e7fe2351bbc,2020-04-14 09:32:09+02:00,Normal,35485,35485,369127,369127,860,354.0,0,1117,0,126
8189976663eb160bfd4b2ae44fd5250da1089744,b9e2355eb07938829a1a31ed7b60e5f72d4b92e3,2020-04-14 13:22:46+02:00,Normal,35485,35485,369237,369219,860,355.0,18,1135,0,126
fc0b48d2e7aaaeb390936916f56dc0631717d022,25afe59d342ac0fb77f523b8da42aa166c6e1503,2020-04-15 10:41:19+02:00,Normal,35493,35493,369376,369376,861,356.0,0,1135,0,126
f1a808a5025b63715d1034af2b96a6a5241d29e9,71c4fb7beb8e3293243140e4bd74e53989196440,2020-04-15 18:31:30+02:00,Normal,35493,35493,369457,369457,861,357.0,0,1135,0,126
4c9886085b774520660844e11d682e194d622df6,7b31ba541f1dfb3a8e782b1319c25a24f9d86f8a,2020-04-17 07:45:52+02:00,Normal,35507,35507,369451,369428,863,358.0,23,1158,0,126
eeab63e57e797c41fa42ffe804927c5f77a0d739,4c9886085b774520660844e11d682e194d622df6,2020-04-17 08:14:27+02:00,Normal,35507,35507,369453,369451,863,359.0,2,1160,0,126
150c3d13a6fdf1a89a0fa90a8f8687fe3757a015,75866b93cc285c87cfc764a32d081493b19c1dc5,2020-04-21 12:08:25+02:00,Normal,35589,35589,369922,369922,867,360.0,0,1160,0,126
d5898db50ec6f77404d96eba5ddac9b50df407a7,150c3d13a6fdf1a89a0fa90a8f8687fe3757a015,2020-04-21 15:46:18+02:00,Normal,35589,35589,369924,369922,867,361.0,2,1162,0,126
fb9b1c245d2fa1fdf2ce3e952eb92adfa1555862,06889d62063f0d12aaf618101dfc1b07333117be,2020-04-22 08:45:14+02:00,Normal,35580,35580,369938,369938,868,362.0,0,1162,0,126
ca769c8c13df46b8153a0a4ab3d748e88d6e26f9,71d9876e39abafe81e031b92ecd300c7d13346ea,2020-04-27 18:06:11+02:00,Normal,35619,35619,370097,370097,873,363.0,0,1162,0,126
dd3dcd28402b7c9cc7bfd24d3e026db751ca4dfd,67b334fbaf7cfb0936666ea788d406a55a09754c,2020-04-28 10:07:34+02:00,Normal,35619,35619,370128,370128,874,364.0,0,1162,0,126
b28be08cac1f7cde332ca43db65bb733fa3f9bf5,dd3dcd28402b7c9cc7bfd24d3e026db751ca4dfd,2020-04-28 10:09:45+02:00,Normal,35619,35619,370128,370128,874,365.0,0,1162,0,126
2788de95e375cccd03a3dfd161fc92b7d6df6024,b28be08cac1f7cde332ca43db65bb733fa3f9bf5,2020-04-28 10:12:33+02:00,Normal,35619,35619,370128,370128,874,366.0,0,1162,0,126
54646a423b4501aeb80bbdd9238f20500c84cd5f,5869afe32b9c252cacd327f18c58e38c36d1f530,2020-04-29 16:45:00+02:00,Normal,34622,34608,371485,371443,875,367.0,42,1204,14,140
555e3a848e7ac13580371c7eafbc89195fee6ea9,bb13711451157d5081c2d2a297820f6bc131ac27,2020-04-30 09:13:23+02:00,Normal,34616,34622,371089,371487,876,368.0,-398,806,-6,134
909b5cd1aaf1e7a2042f53b82bdb429caafdfb86,a0df5dea3369fab02211d06c2b93109b2cb55175,2020-05-02 14:31:20+02:00,Normal,34643,34643,371512,371521,878,369.0,-9,797,0,134
c5358794e3d893a74073d1ee0a3d173d8f1e04b6,e0998a460ac15464bcdb048ebc52eae0bb1cbd38,2020-05-04 07:04:23+02:00,Normal,34643,34643,371511,371511,880,370.0,0,797,0,134
8e8ff38cb8766590fa3a4f412dbb4b11f65b5c69,c5358794e3d893a74073d1ee0a3d173d8f1e04b6,2020-05-04 07:38:35+02:00,Normal,34643,34643,371511,371511,880,371.0,0,797,0,134
7668f9bce921f66e8e572938154221cd687aaa4a,8e8ff38cb8766590fa3a4f412dbb4b11f65b5c69,2020-05-04 07:42:25+02:00,Normal,34643,34643,371511,371511,880,372.0,0,797,0,134
b73e66e75802f10cc34d4880714554cea54dbf49,d2b9a9fdbbc9b5e19b22b144d3e305b87c03b6c8,2020-05-05 09:08:29+02:00,Normal,34646,34645,371548,371537,881,373.0,11,808,1,135
30083e0780a19c6e7f50c1945d71acef15bbdcdf,fb52176a6f38071a540e8187fcb618d1fd152d09,2020-05-05 11:00:05+02:00,Normal,34646,34646,371547,371547,881,374.0,0,808,0,135
fb52176a6f38071a540e8187fcb618d1fd152d09,b73e66e75802f10cc34d4880714554cea54dbf49,2020-05-05 11:00:05+02:00,Normal,34646,34646,371547,371548,881,375.0,-1,807,0,135
aff7a58aef0264e5b2740e5df07894ecc0d7a580,30083e0780a19c6e7f50c1945d71acef15bbdcdf,2020-05-05 11:30:02+02:00,Normal,34646,34646,371547,371547,881,376.0,0,807,0,135
106e8dc91a76ea62e20acf0a0595f343e154af9b,b7f1c0d86d72df51aa2e25da79d99074b751c7e1,2020-05-07 10:02:14+02:00,Normal,34652,34652,371588,371584,883,377.0,4,811,0,135
f97f71f59249f1fbeebe84d4fc858d70fc456f7d,6137ec2bf2c6398b5980b8cea91ff757a867b222,2020-05-08 06:14:42+02:00,Normal,34627,34627,371552,371552,884,378.0,0,811,0,135
b23e3a1caa10f824b6a0f8bbfaaab7fe53ac3abf,01f8d19ef95af7087f9480372fc9c2a124be2842,2020-05-08 11:38:18+02:00,Normal,34648,34648,372492,372491,884,379.0,1,812,0,135
0668164b4ac93a5be79f5b87fae83c657124d9ab,e6ec76d2455d0fd57ad766acd3714538b24a8989,2020-05-12 08:52:23+02:00,Normal,34690,34690,372853,372837,888,380.0,16,828,0,135
17ea7cc9734a9849166d6c33bd8888bc38bfdd54,58f1b07e49a98bb391c9e38b91f078ab2c302703,2020-05-12 09:06:06+02:00,Normal,34704,34704,372898,372898,888,381.0,0,828,0,135
a9e589030af4b053593fb284ecb4c249d79585be,91e287cce0561b647e7b7fb96dd415567512f279,2020-05-12 11:26:37+02:00,Normal,34704,34704,372898,372898,888,382.0,0,828,0,135
d51e090db2110f016dbca1d794c0d379b3df551b,0b938cb7d2854237d45dc31acaf8ae826d5d8bc7,2020-05-12 11:26:37+02:00,Normal,34704,34704,372898,372898,888,383.0,0,828,0,135
0b938cb7d2854237d45dc31acaf8ae826d5d8bc7,a9e589030af4b053593fb284ecb4c249d79585be,2020-05-12 11:26:37+02:00,Normal,34704,34704,372898,372898,888,384.0,0,828,0,135
6b9b2af7352908d40ca4d31bdb1b80c013cab29a,d51e090db2110f016dbca1d794c0d379b3df551b,2020-05-13 09:07:51+02:00,Normal,34704,34704,372898,372898,889,385.0,0,828,0,135
3b94f12462d262a812930cf25efe8d8eb07c5c83,6b9b2af7352908d40ca4d31bdb1b80c013cab29a,2020-05-13 09:07:51+02:00,Normal,34704,34704,372898,372898,889,386.0,0,828,0,135
4c5236ef93db714b63eedcc5a162631a6ca1def9,3b94f12462d262a812930cf25efe8d8eb07c5c83,2020-05-13 09:07:51+02:00,Normal,34704,34704,372898,372898,889,387.0,0,828,0,135
d106d07f732013eeb4667e73fa9cfd197e1d3484,4c5236ef93db714b63eedcc5a162631a6ca1def9,2020-05-13 09:07:51+02:00,Normal,34704,34704,372904,372898,889,388.0,6,834,0,135
f2187a227f7a3c80282658e699ae9b04023724e5,d106d07f732013eeb4667e73fa9cfd197e1d3484,2020-05-13 09:07:51+02:00,Normal,34704,34704,372904,372904,889,389.0,0,834,0,135
18eb852874a073001cb509f64002b6d82bdc760b,01a381cc17e6747e1d9e7b95a39e885029fd2a81,2020-05-13 15:07:21+02:00,Normal,34704,34704,372884,372881,889,390.0,3,837,0,135
50798d43898c7d46926a4292f86fdf3859a433da,0a627dbe73dee6f5833221b6c67ecce7ebb2b223,2020-05-14 06:22:54+02:00,Normal,34704,34704,372883,372883,890,391.0,0,837,0,135
e536fa5ce1f2249d171c5890751aea58e51b3849,50798d43898c7d46926a4292f86fdf3859a433da,2020-05-14 06:33:00+02:00,Normal,34704,34704,372854,372883,890,392.0,-29,808,0,135
3a941230c85b2702a5e1cd97e17251ce21057efa,03537e245886ed1811444c0993025dc2e08ac38b,2020-05-14 15:07:08+02:00,Normal,34718,34718,372968,372968,890,393.0,0,808,0,135
9d211f149a8141a3990acae4cdada3875b9339b3,81ffedaacc0d907b9feb73783edefdffd0ced606,2020-05-14 17:17:46+02:00,Normal,34726,34726,372987,372987,890,394.0,0,808,0,135
20a8a443f012907843450c0b6f6a34a9fc8138f3,9756c334294ad573d887b449e2fe1cc87387af40,2020-05-19 10:56:39+02:00,Normal,34744,34744,373201,373228,895,395.0,-27,781,0,135
b739f2e91d68aa3d4c5009127a43af037796225a,5af17babb0f895cf129fdeee92548d2ac12e78e2,2020-05-19 22:44:57+02:00,Normal,34744,34744,373213,373201,896,396.0,12,793,0,135
a125da6a7c79b1d4c55677d0bed6f9b1d7d77353,b739f2e91d68aa3d4c5009127a43af037796225a,2020-05-19 22:44:57+02:00,Normal,34744,34744,373239,373213,896,397.0,26,819,0,135
8328811f048fed0dd22573224def8c65410c9f2e,e875fac8868c774b6a99428a812d9a4224d78277,2020-05-20 09:18:19+02:00,Normal,34729,34729,373238,373238,896,398.0,0,819,0,135
9624703a06187060c1a494e533f3e27fed946de3,6dcfa70cac29c854fc5169bed1cf6479eabdb8c1,2020-05-21 22:34:21+02:00,Normal,34777,34777,373579,373579,898,399.0,0,819,0,135
f4bab0982aba90dd1d2a7f9b6141d72f76922fe5,587b179d4115f2e4dbc425d1ae035be9eb22197b,2020-05-27 09:03:53+02:00,Normal,34789,34789,373695,373693,903,400.0,2,821,0,135
803e70b1adb71d86eb5bbb4074ef5ff96ae6e55d,f4bab0982aba90dd1d2a7f9b6141d72f76922fe5,2020-05-27 09:07:02+02:00,Normal,34789,34789,373695,373695,903,401.0,0,821,0,135
42de52affe20e399554d984cc7848bf8e0368b41,62f1655a64795d055f72e53557fb8404c5430963,2020-05-28 09:32:43+02:00,Normal,34802,34802,373767,373767,904,402.0,0,821,0,135
d94a9aa0557a459a5b9b7b82a8c043de14f8b1a0,fa58450a9ab8a1bdd2a5090b51b00078fd85ffa6,2020-05-28 13:05:15+02:00,Normal,34821,34805,373945,373937,904,403.0,8,829,16,151
7fc317ae736e8fda1aaf4d4ede84d95fffaf5281,df32fd42b84cc6dbba173201f244491b0d154a63,2020-06-03 08:47:19+02:00,Normal,34821,34821,374023,374022,910,404.0,1,830,0,151
36a2e9607e3069e875eedfd814d4473d9b6811cb,7ec2658e1e24149f0f3244c08c361348f6ebc0e4,2020-06-03 11:42:42+02:00,Normal,34819,34819,374048,374047,910,405.0,1,831,0,151
229c9c6653356a0bc23846d83b2d4b5d0438a145,54975780ee2e4017844ecad94835fdce43d97377,2020-06-03 13:00:37+02:00,Normal,34819,34819,374048,374048,910,406.0,0,831,0,151
f83b44075dafa429d59e8755aa47e15577cc49f9,8c7992f658e1125f8dc20b19206e8bbbe4187372,2020-06-04 12:26:25+02:00,Normal,34879,34859,374792,374662,911,407.0,130,961,20,171
926148ef019abcac3a9988c78734d9336d69f24e,f83b44075dafa429d59e8755aa47e15577cc49f9,2020-06-05 07:21:52+02:00,Normal,34879,34879,374794,374792,912,408.0,2,963,0,171
78ad4b4b0201003792bfdbf1a7781cbc9ee03539,07506a61147768b95e44ee68d0673851fa5e05bd,2020-06-08 07:21:54+02:00,Normal,34901,34895,374984,374961,915,409.0,23,986,6,177
4339f2aff272bceabd67e452c65bcfe0700b3f09,92309e53d9921a60e667656d8dd65e59eb5cf81c,2020-06-10 06:53:32+02:00,Normal,34907,34907,375075,375075,917,410.0,0,986,0,177
aeb8996a6706cad3e96d8221760c1cb408ee7ed9,5776a1660e54a95159164414829738b665c89916,2020-06-12 07:20:06+02:00,Normal,34915,34915,375159,375146,919,411.0,13,999,0,177
dcb4d79ef719d824431a8b3ff8ada879bbab21cc,7edc6e53a746af995e3b89d53d37938dd8fc46aa,2020-06-16 07:54:41+02:00,Normal,34943,34943,375613,375613,923,412.0,0,999,0,177
e36028fb9c0c3b6d402fef2cdabe06ebb90f6d3a,e29637681be07606674cdccb47d1e53acb930f5b,2020-06-17 07:08:51+02:00,Normal,34978,34978,376138,376138,924,413.0,0,999,0,177
78c811334c9e5477b86fd113fa2c4a261e167d15,e36028fb9c0c3b6d402fef2cdabe06ebb90f6d3a,2020-06-17 07:59:40+02:00,Normal,34978,34978,376087,376138,924,414.0,-51,948,0,177
82da72b74851808c08ec98fe609efe52609f29ad,1621f06051c94665f2edf492c10316875896e7eb,2020-06-17 10:32:43+02:00,Normal,34978,34978,376102,376091,924,415.0,11,959,0,177
02ea98bc2ff972f7705bfffb24843494086d011f,cc7c16af98e4c9a7146c248c8567aac7a50e0fbb,2020-06-23 11:14:27+02:00,Normal,34975,34975,376426,376424,930,416.0,2,961,0,177
1e96de4f974acbdaa25ad4ba1894ea060213174e,fbe82f82555bc25dccb476c749ca062f0b522be3,2020-06-25 11:23:26+02:00,Normal,35004,35004,376740,376725,932,417.0,15,976,0,177
09914ccf688974e068941f55412b930729bafa06,8984cab8a80af8555b1ccfa5b552d411b47f9bca,2020-06-26 22:37:58+02:00,Normal,35014,35014,376816,376816,934,418.0,0,976,0,177
62d85a283500e9abb0e1c9ec53c59be468f056a0,09914ccf688974e068941f55412b930729bafa06,2020-06-26 23:18:59+02:00,Normal,35014,35014,376848,376816,934,419.0,32,1008,0,177
615e32162ff646db3456b90fb4eaaecc33dd3e4e,a93425a37f4defdb31d4ca96bb3bf6da21f0b5ce,2020-06-30 09:50:15+02:00,Normal,35014,35014,376878,376850,937,420.0,28,1036,0,177
0f3aecf581b50215820455eb2f6a19a1b3b3ef8b,b5371539a9d871758d639a85d1f2fd648c1f633d,2020-07-01 06:16:32+02:00,Normal,35014,35014,376880,376880,938,421.0,0,1036,0,177
c2a835703f706583542e9dae82749ac3b92819f8,0f3aecf581b50215820455eb2f6a19a1b3b3ef8b,2020-07-01 07:00:43+02:00,Normal,35014,35014,376880,376880,938,422.0,0,1036,0,177
ae8338daf34fd746771e0678081999b656177bae,cb0da637a69b79ab371be9ee202335190a3a506e,2020-07-07 12:15:05+02:00,Normal,35107,35107,377265,377255,944,423.0,10,1046,0,177
8a6df55f2dd5131282084a4edfd48f63fbf8c69a,1d8256719eecb724476e6cb8d63cfebf6ba1a3cc,2020-07-09 11:55:03+02:00,Normal,35107,35107,377372,377365,946,424.0,7,1053,0,177
2c43840dfba42ed02574a270d826fda08e4b50d1,00727d384be3c98acb46d3913bd9cc460af08582,2020-07-10 18:55:50+02:00,Normal,35138,35138,377672,377672,947,425.0,0,1053,0,177
188f7786bc434a3e5ca7b46d2975a08318fe7452,2c43840dfba42ed02574a270d826fda08e4b50d1,2020-07-10 18:55:50+02:00,Normal,35138,35138,377672,377672,947,426.0,0,1053,0,177
240cbb63bf9965c63d7a3cc9032f91410f414d46,156a2138db20abc89933121e4ff2ee2ce56a173a,2020-07-16 08:16:58+02:00,Normal,35173,35173,377907,377878,953,427.0,29,1082,0,177
9bc8b1ad2d88209bf45f389fe3cc8b94909b0e72,240cbb63bf9965c63d7a3cc9032f91410f414d46,2020-07-16 09:27:09+02:00,Normal,35173,35173,377907,377907,953,428.0,0,1082,0,177
bde33bdd51b58a63d3e50fab687815968383b86d,9bc8b1ad2d88209bf45f389fe3cc8b94909b0e72,2020-07-16 09:43:08+02:00,Normal,35173,35173,377910,377907,953,429.0,3,1085,0,177
3d16496037fbb8a6bbc6b6e354fa4f5eb65e6cea,e7fa8aff432a90b6df9914d63aad239164b6b4d4,2020-07-17 21:15:21+02:00,Normal,35198,35198,377921,377921,954,430.0,0,1085,0,177
f405954ea24dcce7ed01e488a0778be7e441b757,3d16496037fbb8a6bbc6b6e354fa4f5eb65e6cea,2020-07-20 07:10:16+02:00,Normal,35200,35198,377929,377921,957,431.0,8,1093,2,179
83f55aafdd635189c010cff403f66b54d695921a,730711e8282893723f993f55d3e3b0c823cfdb9a,2020-07-20 09:48:31+02:00,Normal,35202,35202,377997,377978,957,432.0,19,1112,0,179
c071c408d72330b422c124a6bdd85a68acae9566,80a8be03d9321669a239dbced8ac48a4ebbbb7e1,2020-07-22 10:57:38+02:00,Normal,35236,35236,378291,378279,959,433.0,12,1124,0,179
fd53db842c35c994dbd54196dd38a908f3676b1a,c071c408d72330b422c124a6bdd85a68acae9566,2020-07-22 12:49:56+02:00,Normal,35236,35236,378295,378291,959,434.0,4,1128,0,179
f4e93919e4608cfc50849a1f764fd856e0917401,c1f8d87bb0ac72b213bf31e672bd34c93bda6b18,2020-07-27 06:39:02+02:00,Normal,35248,35248,378369,378352,964,435.0,17,1145,0,179
02447fb133b53ec7d0ff068cc08f06fdf8817ef7,628c4a26eee93417bb7161aa393dffb3f4c146b2,2020-07-28 11:54:01+02:00,Normal,35258,35258,378472,378474,965,436.0,-2,1143,0,179
ba691933cee375195c9c50f333dd4b2a3abbb726,7dbbe65647a54283fadf2c51f11a750a74425d7b,2020-07-28 13:06:52+02:00,Normal,35258,35258,378470,378470,965,437.0,0,1143,0,179
8703680ebee47bfa9e912a30a0509798500bf42a,0b655a4bf81f640d3e664f398e635943d4fb7812,2020-07-31 11:33:17+02:00,Normal,35306,35306,379057,379057,968,438.0,0,1143,0,179
88af11c58baf0eae2fa947a5f0733906ffe6bb38,8703680ebee47bfa9e912a30a0509798500bf42a,2020-07-31 12:38:09+02:00,Normal,35306,35306,379060,379057,968,439.0,3,1146,0,179
1d6fdca557e674b9a789b51caadca8985e588492,f4ac167119e8897c398527c392ed117326496652,2020-07-31 22:05:02+02:00,Normal,35341,35341,379315,379308,968,440.0,7,1153,0,179
7c929fcf7c8913d0bd78a8400eafe866ceed9aa6,1d6fdca557e674b9a789b51caadca8985e588492,2020-08-01 20:39:18+02:00,Normal,35341,35341,379316,379315,969,441.0,1,1154,0,179
b68b8cb89abb35ff2152175ea540619ec384b1f4,1a60838fa688d3c1e245ebe4cfe7038ccd67ae3b,2020-08-03 08:52:28+02:00,Normal,35341,35341,379316,379316,971,442.0,0,1154,0,179
bce4a53670668d6fd1e34685197151c17fd1b378,b68b8cb89abb35ff2152175ea540619ec384b1f4,2020-08-03 20:50:45+02:00,Normal,35341,35341,379316,379316,971,443.0,0,1154,0,179
d907371ef99a1e4ca6bc1660f57d81f265750984,bce4a53670668d6fd1e34685197151c17fd1b378,2020-08-04 09:35:24+02:00,Normal,35349,35341,379465,379316,972,444.0,149,1303,8,187
df37c2ec761f0032f508af38ce03dee7f4f3f149,d907371ef99a1e4ca6bc1660f57d81f265750984,2020-08-04 09:47:34+02:00,Normal,35349,35349,379465,379465,972,445.0,0,1303,0,187
6c1923029748de4a0f443260751a93c1e0ea10fa,df37c2ec761f0032f508af38ce03dee7f4f3f149,2020-08-04 10:34:38+02:00,Normal,35349,35349,379465,379465,972,446.0,0,1303,0,187
e70dc506d76083e443a37bac5058151823802e29,b0af56f639179ac5a70253b07ead8b768c4ef4a9,2020-08-05 10:54:25+02:00,Normal,35350,35350,379480,379479,973,447.0,1,1304,0,187
99abfe8f4d3caebcd73548f5bf9e4755bdfed318,e5118b545b05653d9ea18c7733996b2e38c0ff8f,2020-08-07 21:42:39+02:00,Normal,35390,35373,379624,379608,975,448.0,16,1320,17,204
287e36bd227a694ba008c28fda1904fbe92df123,804f2b70244d435c63f7f7c6312a829bc41b2ca4,2020-08-11 10:31:09+02:00,Normal,35426,35410,379815,379805,979,449.0,10,1330,16,220
8a5683b6b2aede38edcff070686ed1fce470dec5,287e36bd227a694ba008c28fda1904fbe92df123,2020-08-11 10:31:44+02:00,Normal,35426,35426,379815,379815,979,450.0,0,1330,0,220
21768a99f47ee73a2f93405151550ef7c3d9c8a2,51297a92324976a704279b567ec4f80bb92d7b60,2020-08-13 16:29:55+02:00,Normal,35432,35432,380096,380096,981,451.0,0,1330,0,220
d534b5734f5087cb0b9a20bd7cd28bfda93c71b0,dd5173ca1b3e65f8664ad90b81cba032826991dc,2020-08-18 06:28:30+02:00,Normal,35448,35448,380283,380283,986,452.0,0,1330,0,220
13704b057d3c77d9442a150f79d8fad34bcdb995,d534b5734f5087cb0b9a20bd7cd28bfda93c71b0,2020-08-18 09:30:31+02:00,Normal,35448,35448,380283,380283,986,453.0,0,1330,0,220
35b03788b0607c1f8d2b64e4fa9e1669b0907ea4,3254991762b49cfbeb8434842c19bbbad87cd9c6,2020-08-18 09:37:15+02:00,Normal,35456,35452,380343,380319,986,454.0,24,1354,4,224
3254991762b49cfbeb8434842c19bbbad87cd9c6,13704b057d3c77d9442a150f79d8fad34bcdb995,2020-08-18 09:37:15+02:00,Normal,35452,35448,380319,380283,986,455.0,36,1390,4,228
4376c2c7f8cd9c7604a7d053b3c4022dd5ac2795,bf6d07730c41ae23836d8dae98626fe8614307e2,2020-08-19 12:06:00+02:00,Normal,35456,35456,380370,380356,987,456.0,14,1404,0,228
04e87e79a0bd2b1b9fdc30f884a637a3268733f0,b5acb9db751c3e179cdd55398432dfad2c259628,2020-08-24 11:37:59+02:00,Normal,35454,35456,380413,380430,992,457.0,-17,1387,-2,226
bb8f66934d93faf80cd1a2dda65aaedce21a6fc5,04e87e79a0bd2b1b9fdc30f884a637a3268733f0,2020-08-24 11:37:59+02:00,Normal,35454,35454,380369,380413,992,458.0,-44,1343,0,226
0b0658111cba538b91072b9a133fd5545f3f46d1,9f8c7d2b4b3cc707a8a94b793ec8fe7a11423eda,2020-08-25 10:02:56+02:00,Normal,35454,35454,380400,380400,993,459.0,0,1343,0,226
1251772cb83aa4106f526fe00738e51c0eb59122,9c92924cd5d164701e2514e1c2d6574126bd7cc2,2020-08-26 22:13:37+02:00,Normal,35467,35456,380524,380480,995,460.0,44,1387,11,237
e39e727ded673e74016b5d3658d23cbe20234d11,e02738bf55f66939be63f75d4fdcdc2ebc36e435,2020-08-28 05:57:36+02:00,Normal,35467,35467,380512,380512,996,461.0,0,1387,0,237
22105391424cc56f29f153bb76d6a15246152674,4c0b4720b0d5b025bc0ce4149eb501b9dde8c03f,2020-08-28 19:09:41+02:00,Normal,35474,35474,380596,380588,996,462.0,8,1395,0,237
0be51d2226fce030ac9ca840535a524f41e9832c,22105391424cc56f29f153bb76d6a15246152674,2020-08-28 19:09:46+02:00,Normal,35474,35474,380586,380596,996,463.0,-10,1385,0,237
8d7271578d7b153435b40fe40236ebec43cbf1b9,2bc38bc7cae002f949157d95e3f0c19ea6b8ca5c,2020-09-01 09:17:23+02:00,Normal,35474,35474,380713,380686,1000,464.0,27,1412,0,237
1853724acaf17ed7414d54c7d2b5563a25025a71,8d7271578d7b153435b40fe40236ebec43cbf1b9,2020-09-01 09:17:23+02:00,Normal,35474,35474,380742,380713,1000,465.0,29,1441,0,237
6a881197e92a03a8bb7c91440d0a702b6dfd6736,2d42e23b6d8fd76f93a96b2310b2c9dfd441d009,2020-09-02 15:16:03+02:00,Normal,35480,35480,380789,380786,1001,466.0,3,1444,0,237
8d59075184f4cd2852b374359850ff7aeb412ec1,0b8871ab6744285943784795ede053839ee009ef,2020-09-03 12:06:42+02:00,Normal,35481,35481,380799,380799,1002,467.0,0,1444,0,237
e6b5108acc79dcff5bc90bc97500569c74a807bc,17407eca59b0572228067cdee51433f49a1e0adb,2020-09-04 20:27:23+02:00,Normal,35484,35484,380968,380946,1003,468.0,22,1466,0,237
453967477e3ddae704cd739eac2449c0e13d464c,2808cdc8fb15ad27f83af3e62db69f5ea7ced29e,2020-09-09 09:05:28+02:00,Normal,35483,35483,381097,381097,1008,469.0,0,1466,0,237
438b85dfab4f16a2e709e2bcdbfefecd7bfee89e,9369f0cebba1f65909a14dec6aa3515ec1eb2557,2020-09-10 11:00:13+02:00,Normal,35483,35483,381147,381147,1009,470.0,0,1466,0,237
3b8857b51ab4ab2ef19bcfc665a427e19a7aabc0,9a0e5052ed5509cc582b1b3eeaa30f85858fee48,2020-09-13 20:09:44+02:00,Normal,35506,35506,381343,381345,1012,471.0,-2,1464,0,237
9a0e5052ed5509cc582b1b3eeaa30f85858fee48,12d6cae7c0401baa70c934f465bad856afecc847,2020-09-13 20:09:44+02:00,Normal,35506,35506,381345,381345,1012,472.0,0,1464,0,237
e11d05e0b488a3ff2b3c9d8f2e1e50f471750d6e,5fab16392fc00702a5d0288378892ec48fe67dc6,2020-09-14 20:07:44+02:00,Normal,35506,35506,381451,381436,1013,473.0,15,1479,0,237
eaf9764d3bb25970da89de5799d8d308715628ba,7be6a6a4d665061e8bc6a741b16ff92353f5d19e,2020-09-15 11:40:59+02:00,Normal,35486,35486,381577,381563,1014,474.0,14,1493,0,237
3a9f192b131f7a9b0fe5783c684b23015fa67cc8,b4d46df5cad6c936d83dd4f8038d0dc1121bc21e,2020-09-16 11:47:02+02:00,Normal,35486,35486,381628,381627,1015,475.0,1,1494,0,237
ba6b32e5efc4c813ba4432777b3b1743d4205d14,278b6187d2a6711afb0b35dc5c3c09fe5be9adb3,2020-09-21 06:25:23+02:00,Normal,35487,35487,381645,381645,1020,476.0,0,1494,0,237
f7806193e6db2dcc82937041cf07036e752515cd,2d2fbc3a70e4c3c38f0f78869dacd5588aa6a3bd,2020-09-22 10:29:59+02:00,Normal,35490,35490,382112,382111,1021,477.0,1,1495,0,237
75d7af43c104afeb0f101a79535cb63814d6d0f9,f7806193e6db2dcc82937041cf07036e752515cd,2020-09-22 10:30:53+02:00,Normal,35490,35490,382112,382112,1021,478.0,0,1495,0,237
77caeaea888d1744416b213036ff29699758de76,7b9596b974fb0ad1868b10c8c2174e10b72be403,2020-09-23 10:54:04+02:00,Normal,35492,35492,382226,382160,1022,479.0,66,1561,0,237
10a289745f8ecb558f5c22d734315c96d8d4b96e,599f2f79e22aaa475e45b72768babf70ac71a6b2,2020-09-25 10:04:10+02:00,Normal,35576,35576,382329,382329,1024,480.0,0,1561,0,237
e4ab44a4b2ef70be09c35c9197a19fd2e993b4d6,33e91f3ed8ce6412d9d0964acb59166579b9b20c,2020-09-25 10:09:28+02:00,Normal,35576,35576,382359,382329,1024,481.0,30,1591,0,237
33e91f3ed8ce6412d9d0964acb59166579b9b20c,10a289745f8ecb558f5c22d734315c96d8d4b96e,2020-09-25 10:09:28+02:00,Normal,35576,35576,382329,382329,1024,482.0,0,1591,0,237
5a1f0f131885e2eeec473e5ee23c72995d8149bd,8ee4bb6ffcb3346c0fa8fb194986fbf9edadc822,2020-10-01 07:22:28+02:00,Normal,35588,35588,382628,382628,1030,483.0,0,1591,0,237
85fa24e3eb8d0f942ef05c48ea8b0a84659e7ce4,5a1f0f131885e2eeec473e5ee23c72995d8149bd,2020-10-01 07:52:45+02:00,Normal,35588,35588,382628,382628,1030,484.0,0,1591,0,237
292b3be698ef58aff9c215d62a444f66ead578c3,06c5d3fafc6aeb96387148726713b611aeba7fa1,2020-10-02 13:29:50+02:00,Normal,35588,35588,382522,382522,1031,485.0,0,1591,0,237
fce389af7cf95151118c9fc7cafd777a31f94946,efe74fff25e1e85402ecb73d80eea7625246f4ea,2020-10-06 11:25:04+02:00,Normal,35588,35588,382680,382677,1035,486.0,3,1594,0,237
999cddd58d30469f3ee85278985313fdf528323d,143d8e1ab3b7097c7d2bdf77096b96739b6239c6,2020-10-06 12:51:35+02:00,Normal,35598,35588,382699,382678,1035,487.0,21,1615,10,247
e18156b6c35908f2a4026287b5225a6a4da8af1a,c9f12f149f4c42aa34b3cbea17e964dfbf942cfb,2020-10-13 08:35:01+02:00,Normal,35657,35657,382957,382957,1042,488.0,0,1615,0,247
ee0abac169c2dcc6818d583247903c2a8ef55f7c,bbd55e58639c33b4c5adff5f41b78deffc915c11,2020-10-14 20:56:04+02:00,Normal,35688,35688,383248,383229,1043,489.0,19,1634,0,247
bbd55e58639c33b4c5adff5f41b78deffc915c11,7e1e198494d4fc72cf6e153f9d24fe2493c17dc1,2020-10-14 20:56:04+02:00,Normal,35688,35688,383229,383215,1043,490.0,14,1648,0,247
1f31027bb3ad460864fbcbbb89eeb328c0a2f184,1d650ad019c1ab8e73d1e5b2587bb232c8ab35b6,2020-10-14 20:56:04+02:00,Normal,35688,35688,383206,383175,1043,491.0,31,1679,0,247
1d650ad019c1ab8e73d1e5b2587bb232c8ab35b6,7bfdd3b95131805513465863b49511557182c978,2020-10-14 20:56:04+02:00,Normal,35688,35688,383175,383140,1043,492.0,35,1714,0,247
7e1e198494d4fc72cf6e153f9d24fe2493c17dc1,1f31027bb3ad460864fbcbbb89eeb328c0a2f184,2020-10-14 20:56:04+02:00,Normal,35688,35688,383215,383206,1043,493.0,9,1723,0,247
7bfdd3b95131805513465863b49511557182c978,ee005328c8eec5c013c6bf9d6fbb2ae9d540df14,2020-10-14 20:56:04+02:00,Normal,35688,35688,383140,383102,1043,494.0,38,1761,0,247
220c4d5c05a0522fb3fb8d400d69faacca7385ec,ee0abac169c2dcc6818d583247903c2a8ef55f7c,2020-10-15 07:11:11+02:00,Normal,35688,35688,383248,383248,1044,495.0,0,1761,0,247
6e4f7ec8540b2c93b2f5bedb3fe5556e0b757494,220c4d5c05a0522fb3fb8d400d69faacca7385ec,2020-10-15 08:17:42+02:00,Normal,35688,35688,383249,383248,1044,496.0,1,1762,0,247
1fb97fb965786a4398a2236e4e619b78a25d5875,a492ccf0bc3da0b99c27b44e491ec3d6aabd5d3f,2020-10-15 22:05:16+02:00,Normal,35696,35696,383328,383323,1045,497.0,5,1767,0,247
b3b0be3df3108afe8522036cda2e589187c49e2e,afcad0f1b18ad6a2068a405b06fa7468a85fddf2,2020-10-19 19:22:37+02:00,Normal,35710,35710,383414,383414,1048,498.0,0,1767,0,247
0f182558484ec7964413fc93f6361f0842135b2b,b3b0be3df3108afe8522036cda2e589187c49e2e,2020-10-19 19:54:23+02:00,Normal,35710,35710,383414,383414,1048,499.0,0,1767,0,247
197b55c53469cf8344d1ba35175236780cb83bd1,f7963615eb7286fa8bff9b294c28452cf13738d0,2020-10-20 09:49:05+02:00,Normal,35726,35726,383507,383507,1049,500.0,0,1767,0,247
34180922380cf41cd684f846ecf00f92eb289bcf,284bde3fbe07485d64289e28014a4eada68aef91,2020-10-22 13:21:14+02:00,Normal,35751,35749,383916,383887,1051,501.0,29,1796,2,249
009fddc96b88a9aee1232d6a2637f2970fdcfb50,542b4b3ab44d33dfd9b00c22f624ee4aed6f7534,2020-11-03 11:38:40+01:00,Normal,35701,35701,384527,384521,1063,502.0,6,1802,0,249
13b6fff11703a694e155b84d41d02822bbc0aaa0,658bcc16f1b814b3a063d3fa16fabaea8b471863,2020-11-06 08:48:11+01:00,Normal,35720,35720,384949,384949,1066,503.0,0,1802,0,249
1fd9b44a6b1bde29fb1f6746e007787505608974,cc2269350548307e3fe31723ff4e40a879a7a173,2020-11-10 09:56:15+01:00,Normal,34082,34082,384636,384633,1070,504.0,3,1805,0,249
d26d1c196dbb82bf034608576b1019b163086e51,50c3ac6fa9b7c8a94a6d1dc87edf775e3bc4d575,2020-11-11 09:17:20+01:00,Normal,34106,34106,384734,384716,1071,505.0,18,1823,0,249
bec415b290b68c07adcd9c67631b6573666d76be,fecfec6debb32a2a3fb3adf00abecdabdc9b96b9,2020-11-24 18:11:19+01:00,Normal,34138,34138,384982,384975,1084,506.0,7,1830,0,249
b996424199cca58f64b77faeaa367b7e7efb9776,bec415b290b68c07adcd9c67631b6573666d76be,2020-11-24 18:11:19+01:00,Normal,34133,34138,384981,384982,1084,507.0,-1,1829,-5,244
f5e5aac59ebbcea46b98d37834915de0f43d7cc8,b996424199cca58f64b77faeaa367b7e7efb9776,2020-11-25 12:19:45+01:00,Normal,34133,34133,385001,384981,1085,508.0,20,1849,0,244
aade2b461acafd16cfc82449b3df88a0f1c1c197,fe6e5824218bab7cf47dee112d68325b338f9947,2020-11-25 20:39:54+01:00,Normal,34133,34133,385022,385023,1085,509.0,-1,1848,0,244
931c6e982c078073dfa9b5dc1ef0059f8c787719,b37be072a27f3d4aaf22342a17afd0c24518ff8b,2020-11-28 07:41:54+01:00,Normal,34154,34154,385400,385394,1088,510.0,6,1854,0,244
3828427f634e1880467689e4cf0f8ffee95f0d05,58740c0d7f441e7a12e5847fcd7409a78d9edd7b,2020-11-30 06:34:22+01:00,Normal,34179,34179,385470,385442,1090,511.0,28,1882,0,244
58740c0d7f441e7a12e5847fcd7409a78d9edd7b,b9fd09d21b722c3745501151f9cbd5b95ccc3177,2020-11-30 06:34:22+01:00,Normal,34179,34179,385442,385442,1090,512.0,0,1882,0,244
670261b8d6d8196943013ebe9698f99fd9dde43c,55fabc53373a8c7ef31d8c4cffd2a07be0a88c2e,2020-12-01 06:24:16+01:00,Normal,34179,34179,385462,385462,1091,513.0,0,1882,0,244
adb40d217ec57ade46b1394cfbf3c513dc669445,670261b8d6d8196943013ebe9698f99fd9dde43c,2020-12-01 07:12:49+01:00,Normal,34179,34179,385462,385462,1091,514.0,0,1882,0,244
d746f28949c009251a8741ba03d156964050717f,48b4bae983a1f9a73624fe62ef5bd1130b0dba39,2020-12-03 09:30:33+01:00,Normal,34187,34187,385599,385597,1093,515.0,2,1884,0,244
85729545f11257b7790e098fb224637715263616,e23484484c98fa55f501f6dda6423c6616898f27,2020-12-07 11:45:38+01:00,Normal,34187,34187,385579,385579,1097,516.0,0,1884,0,244
30f2d1af03b1f1e981e8e15151079795914f8f2c,148702e7258eafb27d5488b33a723c87d898e22b,2020-12-08 08:54:50+01:00,Normal,34201,34187,385593,385562,1098,517.0,31,1915,14,258
0f00560d45ab2931647b0cbe44a27c37c576c6dc,30f2d1af03b1f1e981e8e15151079795914f8f2c,2020-12-08 08:54:54+01:00,Normal,34201,34201,385606,385593,1098,518.0,13,1928,0,258
5ce31d6a7142ca8c76d6b52fa42b3406b9a8ff48,2c5d6dc44779448de1497f32c925c96975fae461,2020-12-09 21:27:32+01:00,Normal,34201,34201,385644,385604,1100,519.0,40,1968,0,258
00a1d42bf0d83ba4b329271433eb5e3fd0f704fe,275dd4ebbabbbe758c7219a3d666953d5a7b072f,2020-12-10 18:48:07+01:00,Normal,34206,34206,385798,385797,1100,520.0,1,1969,0,258
965d2d95c630939b53eb60d9c169f5dfc77ee0c6,e251dd8230c0aa09ad7eb899bd36443d75ec51cf,2020-12-15 08:51:58+01:00,Normal,34213,34213,385867,385867,1105,521.0,0,1969,0,258
0ecc70b15aa3831c3945f55c1139ae15900b6104,0ed6f3ba4b9d883ad0d961c6e65c455c3379e1b9,2020-12-15 21:12:26+01:00,Normal,34294,34294,386212,386212,1106,522.0,0,1969,0,258
ada83fd8b89ab194194c9069eef4d6ee6cbec0ee,8b2a30f6f16cb1f3538847954030d69da005bc7f,2020-12-23 07:48:45+01:00,Normal,34304,34304,386419,386417,1113,523.0,2,1971,0,258
ce30e750e6259068ac348aa71f855a5f70d2d49f,c76d51b3ad34bc2ed2155054bfb283ef53beb26a,2020-12-29 08:56:39+01:00,Normal,34301,34301,386471,386488,1119,524.0,-17,1954,0,258
72d04e03855536cf36090aedbb7aa8f1c4c8b443,ce30e750e6259068ac348aa71f855a5f70d2d49f,2020-12-29 09:01:35+01:00,Normal,34301,34301,386471,386471,1119,525.0,0,1954,0,258
45519937e52c194776a26ec11a32f32958df7f10,72d04e03855536cf36090aedbb7aa8f1c4c8b443,2020-12-29 09:01:35+01:00,Normal,34301,34301,386581,386471,1119,526.0,110,2064,0,258
98ad327864aed8df245fd19ea9d2743279e11643,45519937e52c194776a26ec11a32f32958df7f10,2020-12-29 09:04:35+01:00,Normal,34306,34301,386602,386581,1119,527.0,21,2085,5,263
74fd233b1433da8c68de636172ee1c9c6d1c08c9,e64c1d8055a3e476122633da141f16b50f0c4a2d,2020-12-30 09:01:56+01:00,Normal,34307,34307,386638,386636,1120,528.0,2,2087,0,263
e13b71403bd1568abed237858127677144d43d23,a2e3f95b0937f3f1e4a479db219392eb6ded39f7,2020-12-31 13:18:57+01:00,Normal,34303,34303,386676,386681,1121,529.0,-5,2082,0,263
5bcba16c0120d4a1bb661f0a495dc47f5ed5465d,6a054f768136de2caeaecf6c0fe9ffad76281373,2021-01-06 20:15:14+01:00,Normal,34303,34303,386704,386704,1127,530.0,0,2082,0,263
407d3cf39cd6a62f7277e401d646a4c7e8446879,cd3019bc106eed27b2f97776e4dd9ec7cbac29b2,2021-01-11 11:45:20+01:00,Normal,34319,34308,386869,386855,1132,531.0,14,2096,11,274
fdc3d9dcaf87fb0a1350154561053faa331c3b69,64331419c848a8b6835b25f2c600d7150f722c96,2021-01-12 10:51:38+01:00,Normal,34324,34324,386929,386929,1133,532.0,0,2096,0,274
8774b1144c08f18e23381ffae7084dbc05ebfe37,f20a622aea7144b0014e54be19e6173bddb154f9,2021-01-14 17:50:04+01:00,Normal,34507,34507,388839,388839,1135,533.0,0,2096,0,274
a948d9df394aafded78d72b1daa785a0abfeab48,b4c5f878bd8d8ba4850ab0f1811cc321e5a627ac,2021-01-14 17:50:04+01:00,Normal,34375,34375,387081,387081,1135,534.0,0,2096,0,274
b4c5f878bd8d8ba4850ab0f1811cc321e5a627ac,0aa6a602b2b1cac6fe8e55051eed493b9cea7b81,2021-01-14 17:50:04+01:00,Normal,34375,34375,387081,387081,1135,535.0,0,2096,0,274
0aa6a602b2b1cac6fe8e55051eed493b9cea7b81,e7208f13c0448387e56c340eed46e1ed9ef9997e,2021-01-14 17:50:04+01:00,Normal,34375,34388,387081,387226,1135,536.0,-145,1951,-13,261
e7208f13c0448387e56c340eed46e1ed9ef9997e,2dd6a83d2d7c61321ac4a9b10fbf3c379cb305c3,2021-01-14 17:50:04+01:00,Normal,34388,34395,387226,387578,1135,537.0,-352,1599,-7,254
2dd6a83d2d7c61321ac4a9b10fbf3c379cb305c3,8fdb5a656a35dc9beef4cf2b79a782068263c7ec,2021-01-14 17:50:04+01:00,Normal,34395,34395,387578,387615,1135,538.0,-37,1562,0,254
8fdb5a656a35dc9beef4cf2b79a782068263c7ec,7cb5712edc158396c9d4fbf1ecf17794d9a128b3,2021-01-14 17:50:04+01:00,Normal,34395,34395,387615,387663,1135,539.0,-48,1514,0,254
7cb5712edc158396c9d4fbf1ecf17794d9a128b3,98ae3925e57c3f054814b847971194f7cd8d98d1,2021-01-14 17:50:04+01:00,Normal,34395,34395,387663,387663,1135,540.0,0,1514,0,254
98ae3925e57c3f054814b847971194f7cd8d98d1,be6e46813010f47e3dec22dd8c360df2dcf53369,2021-01-14 17:50:04+01:00,Normal,34395,34395,387663,387688,1135,541.0,-25,1489,0,254
be6e46813010f47e3dec22dd8c360df2dcf53369,d992f4e3c29a81c956d3d616f0bc19701431b26e,2021-01-14 17:50:04+01:00,Normal,34395,34395,387688,387712,1135,542.0,-24,1465,0,254
d992f4e3c29a81c956d3d616f0bc19701431b26e,06eec3197009b88e3a633128bbcbd76eea0b46ff,2021-01-14 17:50:04+01:00,Normal,34395,34401,387712,387839,1135,543.0,-127,1338,-6,248
06eec3197009b88e3a633128bbcbd76eea0b46ff,bf770cc825f1af294b3b2853b39b5b161b6a056f,2021-01-14 17:50:04+01:00,Normal,34401,34404,387839,387858,1135,544.0,-19,1319,-3,245
bf770cc825f1af294b3b2853b39b5b161b6a056f,1adcf20385c2856d3655089ff7a0b55b32e5587a,2021-01-14 17:50:04+01:00,Normal,34404,34404,387858,387889,1135,545.0,-31,1288,0,245
1adcf20385c2856d3655089ff7a0b55b32e5587a,4bb30fe5d598a7acd2a3055c5e66224cf42a75e9,2021-01-14 17:50:04+01:00,Normal,34404,34404,387889,387922,1135,546.0,-33,1255,0,245
6b4941dd577c494cfa49dbeacfd33594ae770047,d32a232fe92e0162030c7905f877d8a07c09e6c7,2021-01-14 17:50:04+01:00,Normal,34404,34418,387945,387986,1135,547.0,-41,1214,-14,231
d32a232fe92e0162030c7905f877d8a07c09e6c7,8250145a0cbfd15aa16c2ad4e2235d1afe3a7359,2021-01-14 17:50:04+01:00,Normal,34418,34418,387986,388014,1135,548.0,-28,1186,0,231
4bb30fe5d598a7acd2a3055c5e66224cf42a75e9,6b4941dd577c494cfa49dbeacfd33594ae770047,2021-01-14 17:50:04+01:00,Normal,34404,34404,387922,387945,1135,549.0,-23,1163,0,231
66b4046d68921edc7c83076da4aafd307f7dd19b,831a05b1859f960dba0aff3ac46daa40ca70704e,2021-01-14 17:50:04+01:00,Normal,34440,34444,388071,388121,1135,550.0,-50,1113,-4,227
b7dd89ed5389067cb70294682ffef1ba23d33934,8774b1144c08f18e23381ffae7084dbc05ebfe37,2021-01-14 17:50:04+01:00,Normal,34507,34507,388839,388839,1135,551.0,0,1113,0,227
88ed1c8d08c70fd3e7943fc8383459545f726dcd,b7dd89ed5389067cb70294682ffef1ba23d33934,2021-01-14 17:50:04+01:00,Normal,34491,34507,388761,388839,1135,552.0,-78,1035,-16,211
810f037b29402f848a766f6900b4ebfbaf64cc88,88ed1c8d08c70fd3e7943fc8383459545f726dcd,2021-01-14 17:50:04+01:00,Normal,34491,34491,388718,388761,1135,553.0,-43,992,0,211
52a238ddf2ceb5211daa2ab23c626473685729b5,810f037b29402f848a766f6900b4ebfbaf64cc88,2021-01-14 17:50:04+01:00,Normal,34471,34491,388604,388718,1135,554.0,-114,878,-20,191
d134b0b93ee10a2128c595997cbc6022c4a982f7,52a238ddf2ceb5211daa2ab23c626473685729b5,2021-01-14 17:50:04+01:00,Normal,34468,34471,388535,388604,1135,555.0,-69,809,-3,188
8250145a0cbfd15aa16c2ad4e2235d1afe3a7359,66b4046d68921edc7c83076da4aafd307f7dd19b,2021-01-14 17:50:04+01:00,Normal,34418,34440,388014,388071,1135,556.0,-57,752,-22,166
157ab32f3446da7fa1f9d716509c290069a2a156,5e33ec80d153416d3693e89138ed21decf042672,2021-01-14 17:50:04+01:00,Normal,34454,34460,388460,388499,1135,557.0,-39,713,-6,160
5e33ec80d153416d3693e89138ed21decf042672,d134b0b93ee10a2128c595997cbc6022c4a982f7,2021-01-14 17:50:04+01:00,Normal,34460,34468,388499,388535,1135,558.0,-36,677,-8,152
12ac4916af034221a4e08ce6b5669e53a0223a67,9e456f3166f6f4f7da9ec00e2160c1edc88fe5b3,2021-01-14 17:50:04+01:00,Normal,34444,34452,388314,388440,1135,559.0,-126,551,-8,144
396da8b94c62cf955ab401eb40a952b7edba0376,12ac4916af034221a4e08ce6b5669e53a0223a67,2021-01-14 17:50:04+01:00,Normal,34444,34444,388297,388314,1135,560.0,-17,534,0,144
68e3ca13d771a8f08a8d1c272308cd44b4dcfa76,396da8b94c62cf955ab401eb40a952b7edba0376,2021-01-14 17:50:04+01:00,Normal,34444,34444,388238,388297,1135,561.0,-59,475,0,144
90c59b4e12e6ff41407694a460f5f30c4688dbfd,68e3ca13d771a8f08a8d1c272308cd44b4dcfa76,2021-01-14 17:50:04+01:00,Normal,34444,34444,388181,388238,1135,562.0,-57,418,0,144
d08977a0f05cf3efb538dcb09d07915d2ede4c67,90c59b4e12e6ff41407694a460f5f30c4688dbfd,2021-01-14 17:50:04+01:00,Normal,34444,34444,388157,388181,1135,563.0,-24,394,0,144
831a05b1859f960dba0aff3ac46daa40ca70704e,d08977a0f05cf3efb538dcb09d07915d2ede4c67,2021-01-14 17:50:04+01:00,Normal,34444,34444,388121,388157,1135,564.0,-36,358,0,144
9e456f3166f6f4f7da9ec00e2160c1edc88fe5b3,157ab32f3446da7fa1f9d716509c290069a2a156,2021-01-14 17:50:04+01:00,Normal,34452,34454,388440,388460,1135,565.0,-20,338,-2,142
f20a622aea7144b0014e54be19e6173bddb154f9,75182a800a621b7a5b2c0a1f39a56e753b9a58ca,2021-01-14 17:50:04+01:00,Normal,34507,34507,388839,388839,1135,566.0,0,338,0,142
88e972e46d71520fbb480642cf957185e5a14a46,e0a46367df8b17905f1c78f5c86f88d21c0f2b4d,2021-01-16 17:37:53+01:00,Normal,34375,34375,387076,387081,1137,567.0,-5,333,0,142
e8b4f23115237047c907fca4565020f30ad35a7c,bef6f7584280f1cc80e5e2d80b7ad073a93d26ec,2021-01-18 12:51:35+01:00,Normal,34377,34377,387145,387142,1139,568.0,3,336,0,142
73ffc73b68d3c1fc1e51f13963718492303a2941,8c7ff7b8cff4a62423512efc3c4fe7955edfeed5,2021-01-19 11:52:47+01:00,Normal,34376,34376,387167,387167,1140,569.0,0,336,0,142
5371342ed66f5ff9feae9dc4586ec43830bbeca6,10d126198434810529e0220b0c6896ed64ca0e88,2021-01-19 12:25:20+01:00,Normal,34374,34374,387269,387322,1140,570.0,-53,283,0,142
cfddca543a6813f595a5ab3eaa221ae620e12ced,dc2ddfe91a45386aceabef5b91936e55aaa47b44,2021-01-20 09:53:34+01:00,Normal,34374,34374,387277,387271,1141,571.0,6,289,0,142
a03a36121d22c8784985c7e45727eddef6a3ea7f,0c42cdf0d2422f4c080e93594d5d15381d6e955e,2021-01-21 09:03:07+01:00,Normal,34400,34374,387421,387377,1142,572.0,44,333,26,168
84ad7f34043c112a932b3ea396ebc98717bfd7e7,2b4b6c8af0aae8785bc1347cf1be2e8e70fd5ff3,2021-01-25 08:40:46+01:00,Normal,34400,34400,387479,387476,1146,573.0,3,336,0,168
b989d213363e0c34ac34ad819a725c7ceb6bbc0b,1adc09064f88b69b3b565b57502f2a0a32b5f3a8,2021-01-26 10:59:05+01:00,Normal,34400,34400,387526,387514,1147,574.0,12,348,0,168
135c800fe6138d7818501a384c0ebbdc5442762c,59e503b6708d41a44f2aa320272de3e2ecb5d65c,2021-01-29 11:00:12+01:00,Normal,34394,34400,387554,387554,1150,575.0,0,348,-6,162
05413afa8c18cdb978fcdf470e09f7a12b234a23,6822aa5c6c3fbec7c5393a05e990865ba59fe167,2021-02-01 09:07:36+01:00,Normal,34393,34393,387578,387546,1153,576.0,32,380,0,162
f749148d62ece28d208ab66b109f858215ba090a,05413afa8c18cdb978fcdf470e09f7a12b234a23,2021-02-01 10:24:22+01:00,Normal,34393,34393,387578,387578,1153,577.0,0,380,0,162
8d3c3a57174a072479978d60f5ecdb9fd3c2fd23,f749148d62ece28d208ab66b109f858215ba090a,2021-02-01 10:51:16+01:00,Normal,34393,34393,387578,387578,1153,578.0,0,380,0,162
f131841c601b9d4884adcdb284b4213c2ad89231,f9cfd346f0222d86bfbac26ef5455806965bae6b,2021-02-02 21:34:36+01:00,Normal,34404,34393,387629,387578,1155,579.0,51,431,11,173
84283ab9cdf20178dabc5a0c06f42a6c3b3801c6,f131841c601b9d4884adcdb284b4213c2ad89231,2021-02-03 10:03:33+01:00,Normal,34404,34404,387624,387629,1155,580.0,-5,426,0,173
f39634ff229887bf7790c069d0c411b38494ca38,84283ab9cdf20178dabc5a0c06f42a6c3b3801c6,2021-02-03 10:03:33+01:00,Normal,34404,34404,387622,387624,1155,581.0,-2,424,0,173
5d9b065d3f93de056588dfee6f1776294dd8bab2,aa29c57beea7e8e570f8a597ea806ca3e2b3431d,2021-02-04 10:47:45+01:00,Normal,34404,34404,387659,387659,1156,582.0,0,424,0,173
ae48601e6d88410626c7d28572f969ab57b33598,f23b05696e470fc113c729e18665722ccbb7a9f0,2021-02-04 14:08:43+01:00,Normal,34404,34404,387692,387671,1156,583.0,21,445,0,173
59841170ba1785ada10a2915b0b60efdb046ee39,6ee86a12ee29fcd4f3d7c9f1ad6de8cde4637b06,2021-02-08 18:12:58+01:00,Normal,34411,34411,387774,387774,1160,584.0,0,445,0,173
ec0ff406311de88f4e2a135d784363424fe602aa,9c6ba876928fd20194ac3238dc06aeae66d7bd50,2021-02-10 10:20:54+01:00,Normal,34438,34447,387645,387853,1162,585.0,-208,237,-9,164
efce21497cc21140c5fe2b133064cd815c97b3f5,466920f6d726eee90d5566e0a9948e92b33a122e,2021-02-18 22:19:56+01:00,Normal,34452,34452,387920,387908,1171,586.0,12,249,0,164
fb93363c499334d48aa95d40842795be5997817e,b1af2cca3aba4cefc69c986d4de6cab6db524bf3,2021-02-23 09:47:30+01:00,Normal,34452,34446,388033,388033,1175,587.0,0,249,6,170
c8837322e8b4068441ffe5dd497ab8a323525d3a,3fd82a62415e748002435e7bad06b5017507777c,2021-02-24 12:57:13+01:00,Normal,34538,34533,388819,388819,1176,588.0,0,249,5,175
af685b5f00a2a38ec596ff905d5f70455185b6d7,c8837322e8b4068441ffe5dd497ab8a323525d3a,2021-02-24 20:24:05+01:00,Normal,34538,34538,388819,388819,1176,589.0,0,249,0,175
e0f82d7992ad7085dcf4ed096a6ad2e3ad89eaae,7cc6899d4176539e5d59a2e921b938904d3a8944,2021-02-25 20:27:10+01:00,Normal,34544,34544,388881,388881,1177,590.0,0,249,0,175
200ae86de6f2088fbae7498ea21165f4f9538762,f6f430d3ff9ca254826e9fcaa968ba02018c6c83,2021-02-26 06:15:52+01:00,Normal,34544,34544,388881,388881,1178,591.0,0,249,0,175
8908846444156eeae88be70332f96759cfce7740,9d7e31cc74d0bb4b56c8cbc791fd8d968d426e51,2021-02-26 20:53:01+01:00,Normal,34544,34544,388918,388914,1178,592.0,4,253,0,175
acddbc57d9072d78a3e3ae56c6c9d28c7daab2d5,64a0d1ef6e7a6739148996e9584bbb61fe3dcc60,2021-02-26 22:12:02+01:00,Normal,34544,34544,388923,388923,1179,593.0,0,253,0,175
9f125fce7971714333d23c7f554411342466721c,acddbc57d9072d78a3e3ae56c6c9d28c7daab2d5,2021-02-26 22:12:25+01:00,Normal,34544,34544,388925,388923,1179,594.0,2,255,0,175
2b1de3dd242b473cd084e7ff9b9b10d488dcabad,7ca7f4495ba746279b734695a8dd137bf7ee0bab,2021-03-03 09:06:36+01:00,Normal,34561,34561,389058,389058,1183,595.0,0,255,0,175
7186c536c44c97ebfacc4672610184e2ce793cea,be8faa7c7590d6b961ad9abdc65588f54194aaab,2021-03-03 11:20:13+01:00,Normal,34546,34561,389063,389057,1183,596.0,6,261,-15,160
05bbff82638731a6abfed2fe0ae06a4d429cb32f,20ddc3b81d849be8fc7961081ccb7a6d7e454a89,2021-03-04 10:43:00+01:00,Normal,34546,34546,389112,389112,1184,597.0,0,261,0,160
c6b07627fcb5d1c8d2082714ef5adb63bee6cf4c,05bbff82638731a6abfed2fe0ae06a4d429cb32f,2021-03-04 11:30:06+01:00,Normal,34546,34546,389112,389112,1184,598.0,0,261,0,160
98d3fd61026457a435ef5b7afce6b6e64e9f241d,d9a266d657f66b8c4fa068408002a4e3709ee669,2021-03-09 11:29:54+01:00,Normal,34595,34595,389276,389276,1189,599.0,0,261,0,160
781acf0987d80b638057ed1203409e3a19944e3b,77e0a35a10e0b839d661ea88c12ec1facb2d4fb6,2021-03-09 18:34:25+01:00,Normal,34614,34614,389303,389303,1189,600.0,0,261,0,160
6f5dbe9dbe45b23b3befe4f1cd2ea13b6049ab96,781acf0987d80b638057ed1203409e3a19944e3b,2021-03-09 18:38:07+01:00,Normal,34614,34614,389303,389303,1189,601.0,0,261,0,160
ba9a2b754452b542d3f472f0acce6f940911aced,6f5dbe9dbe45b23b3befe4f1cd2ea13b6049ab96,2021-03-10 09:16:28+01:00,Normal,34621,34614,389330,389303,1190,602.0,27,288,7,167
a6a94fb966cc128a056f63e83213ab4aeee34004,0df5c8187a9fa9828824ec2b1fdf37d1082d7ebe,2021-03-10 15:37:28+01:00,Normal,34621,34621,389344,389346,1190,603.0,-2,286,0,167
876dc0c1a7dbf569782eb64f62f339c1daeb75e0,99640e24b4c42a9f9b1e02d54aec72c13008276d,2021-03-12 20:17:00+01:00,Normal,34635,34635,389468,389468,1192,604.0,0,286,0,167
4d912e6697784325bc43a6d852fe5a26e6fa235a,876dc0c1a7dbf569782eb64f62f339c1daeb75e0,2021-03-15 08:20:36+01:00,Normal,34635,34635,389468,389468,1195,605.0,0,286,0,167
065832eaec167a45008aa125887ce1215a1f257d,54d91795408c878ad335226a87a44961d7f646a9,2021-03-16 20:22:35+01:00,Normal,34634,34634,389514,389514,1196,606.0,0,286,0,167
54f60bc85df7fe38ba6ef6779996d8544d340d3e,45814af6197cfd8f4dc72ee43b90ecde305a1d5a,2021-03-17 21:53:36+01:00,Normal,34642,34642,389559,389542,1198,607.0,17,303,0,167
fc6fba0aa9e4575c9a1c23ad7031eebb1c112868,2411b8b5eb65fe3d7bcc1ee1f59e2433520c7df6,2021-03-19 08:03:57+01:00,Normal,34639,34639,390058,390058,1199,608.0,0,303,0,167
f099ef3ef53f88160d04d7dcc73859801b05a83e,fc6fba0aa9e4575c9a1c23ad7031eebb1c112868,2021-03-19 08:03:57+01:00,Normal,34639,34639,390058,390058,1199,609.0,0,303,0,167
37044817f9a57126d655f216019e8c8cca7c151b,f099ef3ef53f88160d04d7dcc73859801b05a83e,2021-03-19 08:03:57+01:00,Normal,34639,34639,390058,390058,1199,610.0,0,303,0,167
717b5e633ae7a3f376b897413730002472d14cf0,d11b9ffcc0b1d6b8e87df6319f09bf284196e41a,2021-03-22 08:22:58+01:00,Normal,34670,34670,390160,390158,1202,611.0,2,305,0,167
c4df8b86c7fac52d95eda3440edc397fc13c3e56,037607ff192cc924a282f08390c69cef83aa47a5,2021-03-23 08:27:14+01:00,Normal,34670,34670,390212,390210,1203,612.0,2,307,0,167
037607ff192cc924a282f08390c69cef83aa47a5,562898034f65e17bcdd2d951ac5236a1ec8ea690,2021-03-23 08:27:14+01:00,Normal,34670,34670,390210,390208,1203,613.0,2,309,0,167
71ec102b01fcc85acae3819426a4e02ef423b0fa,c4df8b86c7fac52d95eda3440edc397fc13c3e56,2021-03-23 08:28:47+01:00,Normal,34655,34670,390221,390212,1203,614.0,9,318,-15,152
2cd40263348a9c345a58c44d48922ac3b370a119,71ec102b01fcc85acae3819426a4e02ef423b0fa,2021-03-23 09:16:33+01:00,Normal,34655,34655,390230,390221,1203,615.0,9,327,0,152
94463aa861208b11382c7904272d3529372d6b24,cdd0b213a825fcfe90ae93dcc554fba8c1e5ff5d,2021-03-24 11:44:01+01:00,Normal,34659,34659,390301,390301,1204,616.0,0,327,0,152
83443e62d385e2fc25b176056542c0989feb7732,94463aa861208b11382c7904272d3529372d6b24,2021-03-24 12:18:00+01:00,Normal,34659,34659,390301,390301,1204,617.0,0,327,0,152
5b618f239ceb884c9380cf42361c7cc69bf1e208,e53159747c53ca8db6c338998493fd8697d38fac,2021-03-25 10:33:54+01:00,Normal,34654,34654,390332,390323,1205,618.0,9,336,0,152
3c75f1f3cac7985e8a134fc1c33eb6e01639a04b,038940cf5525c41464a1b9e9ba3801042320b0cc,2021-03-30 11:42:15+02:00,Normal,34681,34681,390589,390588,1210,619.0,1,337,0,152
f6018c1e63a04e0c12e2ca759e76e05ccf5e09de,3c75f1f3cac7985e8a134fc1c33eb6e01639a04b,2021-03-30 11:42:15+02:00,Normal,34681,34681,390597,390589,1210,620.0,8,345,0,152
548dce50cf548e777a0c34b5485a146a0606ae73,f83214a3e15ccadc9e2370dd157ed19bcdb07e2c,2021-03-31 20:34:15+02:00,Normal,34693,34693,390867,390870,1211,621.0,-3,342,0,152
cfe47b7686df0c4c87270a83d6d7f933323ed7e6,548dce50cf548e777a0c34b5485a146a0606ae73,2021-04-01 11:11:07+02:00,Normal,34693,34693,390867,390867,1212,622.0,0,342,0,152
78fea27f690028204c03c28d821cb0c0240a7398,0f7afd6599fd4191231a8897258807c8c24deedf,2021-04-06 08:03:43+02:00,Normal,34710,34710,390988,390983,1217,623.0,5,347,0,152
d4d800ca1addc4141e03c5440a849bb64d1582cd,78fea27f690028204c03c28d821cb0c0240a7398,2021-04-06 08:15:17+02:00,Normal,34717,34710,391084,390988,1217,624.0,96,443,7,159
1eac8468cbde790fecb51dd055a439f4947d01e9,d4d800ca1addc4141e03c5440a849bb64d1582cd,2021-04-06 09:42:31+02:00,Normal,34717,34717,391084,391084,1217,625.0,0,443,0,159
da542ccab6d61e1467199b52f77f64a2d72f5faf,df0a9e6d5ce00fc7890545d854dbea876bd07d9b,2021-04-06 12:44:40+02:00,Normal,34717,34717,391084,391084,1217,626.0,0,443,0,159
c6859f1a684edec7bb33038b4408046a4db0c16d,5b05a45c62f4702a6039cd3de290320c232cb808,2021-04-07 10:28:40+02:00,Normal,34717,34717,391096,391084,1218,627.0,12,455,0,159
619f26d2895d121854b1bed1b535d42b722e2eba,e3cfba0029516aafe40f963378e234df2c0d33bb,2021-04-07 17:07:53+02:00,Normal,34717,34717,391107,391107,1218,628.0,0,455,0,159
dc824e2668fbb4ca753182e743fc5f11192500a7,3ae4344bbd3b5e8bcb039bf701f53b68b317f57b,2021-04-08 09:31:16+02:00,Normal,34717,34717,391144,391144,1219,629.0,0,455,0,159
b9d156761f459c889d0c51e6d421d29d8a2f8ae6,dc824e2668fbb4ca753182e743fc5f11192500a7,2021-04-08 09:31:57+02:00,Normal,34717,34717,391144,391144,1219,630.0,0,455,0,159
b8c9e9fae14676d2e81242cb8df1e2eeef9c3a2d,fc268c8648d0d0375d01d36aa1f05f1172ff1566,2021-04-09 12:56:27+02:00,Normal,34702,34702,391190,391183,1220,631.0,7,462,0,159
3b8527e32b665df91622649550813bb1ec9a9251,b8bb9e1549aa7086c20deae81e3b90b363b4f159,2021-04-13 09:15:04+02:00,Normal,34737,34737,391332,391326,1224,632.0,6,468,0,159
23fa29f6a6659e0f600d216de6bcb79e7f6818c9,a77c9a4229cfef790ec18001b2cd18bd9c4aedbc,2021-04-14 12:23:47+02:00,Normal,34742,34741,391391,391387,1225,633.0,4,472,1,160
338eb65b6ecca9c7334aae94ce0b44a0faca4b1d,08c60cce3b13f6e60d7588206da2d3c71228f378,2021-04-14 20:25:58+02:00,Normal,34742,34742,391392,391392,1225,634.0,0,472,0,160
ca9872905559026af82000e46cde6f7dedc897b6,338eb65b6ecca9c7334aae94ce0b44a0faca4b1d,2021-04-14 21:11:17+02:00,Normal,34742,34742,391431,391392,1225,635.0,39,511,0,160
34d1905712d33e72c76b3a55a4fc24abbd11be6c,5c73fbb6a93ee214678f02ba4027f18dff49337b,2021-04-21 09:41:37+02:00,Normal,34764,34755,391709,391679,1232,636.0,30,541,9,169
c3278bb71fe03132704525abcdf29bb4f1b3f143,6a7af38b072f97d15e06aba87c673c16ecafe5a8,2021-04-22 10:47:10+02:00,Normal,34754,34754,391751,391751,1233,637.0,0,541,0,169
90916f050c64b817fdf2ea13b5c20986005fd029,c3278bb71fe03132704525abcdf29bb4f1b3f143,2021-04-22 17:43:58+02:00,Normal,34754,34754,391759,391751,1233,638.0,8,549,0,169
ac2e6e686906810e9c24ca6c39cae6234ab25557,90916f050c64b817fdf2ea13b5c20986005fd029,2021-04-22 19:57:27+02:00,Normal,34754,34754,391760,391759,1233,639.0,1,550,0,169
2f435e75ab4923c50f0999a77dfc26cff4429deb,ac2e6e686906810e9c24ca6c39cae6234ab25557,2021-04-23 10:06:08+02:00,Normal,34754,34754,391768,391760,1234,640.0,8,558,0,169
0aacbdcf27b258387643b033352e99e6103abda8,170b006ce82b0ecf26dc088f832538b747ca0115,2021-04-23 16:32:53+02:00,Normal,34754,34754,391795,391799,1234,641.0,-4,554,0,169
af609c2f4d3fd22bc9ffa12a844df282ce233936,0aacbdcf27b258387643b033352e99e6103abda8,2021-04-26 06:11:13+02:00,Normal,34754,34754,391799,391795,1237,642.0,4,558,0,169
d68be0494be8b82365f2a5410c9335e539d8efd6,eab71f7690c523b25b867a9cd5bf6fb82a33c6b4,2021-04-27 08:40:52+02:00,Normal,34766,34766,391840,391830,1238,643.0,10,568,0,169
4074f38e1dcc93b859bbbfd6abd8441c3bca36b3,158eca4f93e492a6cc6f0240a0b6da3b7aa98ee6,2021-04-27 10:34:47+02:00,Normal,34768,34768,391888,391855,1238,644.0,33,601,0,169
cd74aad90e09865ae6cd8ca0377ef0a5008d14e9,4074f38e1dcc93b859bbbfd6abd8441c3bca36b3,2021-04-27 10:34:47+02:00,Normal,34766,34768,391894,391888,1238,645.0,6,607,-2,167
187118203197801c6cb72dc8b06b714b23b6dd3d,cd74aad90e09865ae6cd8ca0377ef0a5008d14e9,2021-04-27 10:34:47+02:00,Normal,34766,34766,391926,391894,1238,646.0,32,639,0,167
158eca4f93e492a6cc6f0240a0b6da3b7aa98ee6,d68be0494be8b82365f2a5410c9335e539d8efd6,2021-04-27 10:34:47+02:00,Normal,34768,34766,391855,391840,1238,647.0,15,654,2,169
4f600673d71cd99918755805042b7c039645f712,6e742dabc95b00ba896434293556adeb4dbaee8a,2021-04-28 11:31:17+02:00,Normal,34766,34766,391952,391939,1239,648.0,13,667,0,169
baba733dccadf1bdd2a53e5bc9ec7a3ac7ade589,4f128fcf5dd5099a5ea374a87cad64852a9b62dd,2021-04-29 12:04:30+02:00,Normal,34760,34760,391893,391889,1240,649.0,4,671,0,169
1f643c28b5f2b039c47155692844dbae1cb091cd,54da6e2ac20bde80e0de9e35aa0c40ae1dd13943,2021-04-30 12:59:07+02:00,Normal,34766,34766,391873,391864,1241,650.0,9,680,0,169
623c8cd8f41a99f22d39b264f7eaf7244417000b,62b2e8b37e37a313c63be40e3223ca4e830ebde3,2021-05-04 11:29:23+02:00,Normal,34776,34776,392017,392018,1245,651.0,-1,679,0,169
e1e81aa1c4427411e3c68facdd761229ffea6f6f,a708f39ce67af174df90c5b5e50ad1976cec7cb8,2021-05-06 08:45:23+02:00,Normal,34799,34798,392112,392103,1247,652.0,9,688,1,170
efebcc429f048493d6bc710399e65d98081eafd5,e1e81aa1c4427411e3c68facdd761229ffea6f6f,2021-05-06 09:58:24+02:00,Normal,34799,34799,392112,392112,1247,653.0,0,688,0,170
29779075d7f5e1a8cfe0933661d5255e2d7d3cbd,efebcc429f048493d6bc710399e65d98081eafd5,2021-05-06 10:08:00+02:00,Normal,34799,34799,392112,392112,1247,654.0,0,688,0,170
65a9d0013d202447dd76a9cb3c939aa5c9d23da3,29779075d7f5e1a8cfe0933661d5255e2d7d3cbd,2021-05-06 12:26:25+02:00,Normal,34794,34799,392107,392112,1247,655.0,-5,683,-5,165
b1a4b1f0bdf05adbd3dc4dde14228e68da54c1a3,205c36b58fed5a1a0ff462593fc61b58189027d8,2021-05-11 09:19:25+02:00,Normal,34800,34800,392203,392192,1252,656.0,11,694,0,165
d1f1417caed648db2f81a1ec28c47bf958c01958,e6406853c326ea9210d07766138d2b193c6d1fba,2021-05-12 10:42:01+02:00,Normal,34810,34810,392227,392227,1253,657.0,0,694,0,165
b55699968fc9ee985384c64e37f6cc74a0a23683,b81c7562fc33f50166d5120138d6398dc42b13c3,2021-05-13 08:53:44+02:00,Normal,34840,34820,392414,392328,1254,658.0,86,780,20,185
820408d842a07202a80e6ef7f7a57ec6258d88e6,b55699968fc9ee985384c64e37f6cc74a0a23683,2021-05-13 09:42:26+02:00,Normal,34840,34840,392414,392414,1254,659.0,0,780,0,185
c6d88a18726118c694b6ac4c308642efbe84c151,820408d842a07202a80e6ef7f7a57ec6258d88e6,2021-05-13 13:13:12+02:00,Normal,34840,34840,392443,392414,1254,660.0,29,809,0,185
df5c96299ae30dcf8f152cc43c331fb34d39080e,8c4caee76a5571c6c8050660a6a9fc30ece6678d,2021-05-17 08:26:06+02:00,Normal,34842,34842,392472,392472,1258,661.0,0,809,0,185
958cdf65ae90d26236d1815bbba804729595ec7a,a24fed399ced6be2e9dce4cf28db00c3ee21a21c,2021-05-18 18:24:19+02:00,Normal,34817,34817,392651,392614,1259,662.0,37,846,0,185
66491f08fe86629fa25977bb3dddda06959f65e7,31b6ce9ff938a0968f2e526f5d5e106fd17e3dfa,2021-05-20 12:23:36+02:00,Normal,34816,34816,392696,392697,1261,663.0,-1,845,0,185
3f6d4e22f8bf17c445c95174af8343a006628f00,7ef2398e814e044d54b68359d473cc64902a8c31,2021-05-24 07:26:53+02:00,Normal,34821,34821,392780,392780,1265,664.0,0,845,0,185
f0a9413bd282cce452a5b7418b28b096af10a027,3f6d4e22f8bf17c445c95174af8343a006628f00,2021-05-24 07:26:53+02:00,Normal,34819,34821,392796,392780,1265,665.0,16,861,-2,183
7e51893911237dfca9294e3ca12163ff813fb656,3e0fdf5546b8e172c87f255d55c6ddbe7d69f365,2021-05-25 13:22:40+02:00,Normal,34819,34819,392831,392830,1266,666.0,1,862,0,183
12b19a1d76e1a6f80923c8358290d605dacd65d4,1143f3bb5ecaa2be58f2cd9077f147040291659d,2021-05-26 11:19:47+02:00,Normal,34843,34843,392894,392882,1267,667.0,12,874,0,183
e703b152c6148ddda1b072a4353e9a41dca87f90,a0410ffe8f43d8dcfbaa261e068879698fafdca3,2021-06-01 15:11:42+02:00,Normal,34845,34845,393388,393377,1273,668.0,11,885,0,183
e1d787f1b36d13b95187f8f425425ae1b98da188,46572de2e92fdeaf047f80c44d52269e54ad68db,2021-06-02 10:58:39+02:00,Normal,34851,34845,393438,393405,1274,669.0,33,918,6,189
d9cee3f5f2f90938d2c2c0230be40c7d50aef53d,ba10772bf659a9507075d713c416882ce2c8df28,2021-06-02 12:16:38+02:00,Normal,34851,34851,393438,393438,1274,670.0,0,918,0,189
62e8f369c3bdb7dbfe76d128437c0a9c0715a067,f0d0d29f03448ba4f9cfef03f0605cc7e557c2c4,2021-06-03 08:59:37+02:00,Normal,34853,34853,393493,393449,1275,671.0,44,962,0,189
f10c52afabac25f2c10aca26d32dbe7e0e46082e,0d2816133c7e81966bec36b2e3af2fa1ff4f12c2,2021-06-03 12:07:30+02:00,Normal,34851,34851,393502,393501,1275,672.0,1,963,0,189
213850b4b9641bdcb714172999725ec9aa9c9e84,2e4711c611896ae6490d3fa3f8d0c506f2ff3673,2021-06-04 12:53:11+02:00,Normal,34851,34856,393533,393550,1276,673.0,-17,946,-5,184
faba5b702a9c5bb9452a543100928bcb5f66ebcf,c0e29cec83d000cc0b1087214e4658074fa0499c,2021-06-08 11:35:05+02:00,Normal,34838,34843,393789,393803,1280,674.0,-14,932,-5,179
fcd44b889f36c4be87910745614a0a4c88d7a3d8,faba5b702a9c5bb9452a543100928bcb5f66ebcf,2021-06-08 16:39:00+02:00,Normal,34838,34838,393789,393789,1280,675.0,0,932,0,179
8f89454bbc873a117cc8614f2d1f1fbfd4e79ee4,fcd44b889f36c4be87910745614a0a4c88d7a3d8,2021-06-09 08:58:41+02:00,Normal,34838,34838,393794,393789,1281,676.0,5,937,0,179
8b4983cfd429e17c8092f4ff775915327effa6fa,66ed03e7c9ae4cd754aa918c6f4c9227cf424141,2021-06-10 13:25:05+02:00,Normal,34838,34838,393938,393938,1282,677.0,0,937,0,179
fa0433d05f213afe4c67055006320f7aba4c8108,57bc16b38ec75fc96829f912d57a58d8c6358e8f,2021-06-10 20:03:43+02:00,Normal,34839,34838,393972,393938,1282,678.0,34,971,1,180
57bc16b38ec75fc96829f912d57a58d8c6358e8f,8b4983cfd429e17c8092f4ff775915327effa6fa,2021-06-10 20:03:43+02:00,Normal,34838,34838,393938,393938,1282,679.0,0,971,0,180
e07609a0d1cac573890380ee32b85d7743632650,b69b0c3fe871167a0ca01bb439508e335143801f,2021-06-22 06:28:42+02:00,Normal,34848,34848,394156,394133,1294,680.0,23,994,0,180
27e156fa316e9e51e4bce1277bd0fa02b07cd16a,fff4870bfa7ed4d9ab6be0060364b23c66ad1af0,2021-06-24 11:47:29+02:00,Normal,34843,34843,394269,394266,1296,681.0,3,997,0,180
5371ad1d149480bf64c37b3273e06a1c76fe4b90,503ee41497f346de27843a4ea976c57303c76558,2021-06-29 20:23:59+02:00,Normal,34828,34828,394414,394454,1301,682.0,-40,957,0,180
8e97698d7b537cd298438a8d7b55916d275ff851,775f7506d7fbabf79d8bdec4ccf039ce2870fe70,2021-07-01 06:52:41+02:00,Normal,34825,34825,394477,394477,1303,683.0,0,957,0,180
dae83a24519d6f284c74414e0b81d64d9b5a0db4,62988afbea7c7ea6ea7eb76382b3a87a5ccf310c,2021-07-01 09:42:54+02:00,Normal,34825,34825,394477,394477,1303,684.0,0,957,0,180
bcea1a3193d44d8c587173c00abb2eaf61fb9cf7,dae83a24519d6f284c74414e0b81d64d9b5a0db4,2021-07-01 09:43:15+02:00,Normal,34825,34825,394477,394477,1303,685.0,0,957,0,180
8feb2a49fa37528823cc900bbd9609319738193e,bcea1a3193d44d8c587173c00abb2eaf61fb9cf7,2021-07-01 09:57:08+02:00,Normal,34825,34825,394477,394477,1303,686.0,0,957,0,180
1ff0ea6e9bd11788ca6f1ab09291f177934f589e,aba9c2de669dcc0278c7ffde7981be91801be00b,2021-07-05 12:05:13+02:00,Normal,34850,34850,394731,394732,1307,687.0,-1,956,0,180
49ca6bbc445cb75ee742b215f5f90465ad8e7309,edde2a069929c93e37835dc3f7c9a229040058e2,2021-07-05 15:22:08+02:00,Normal,34850,34850,394759,394759,1307,688.0,0,956,0,180
355ecd141671e34853d1ff99ffdb1a7fb95b4276,cf6774a53b40243d35183b4300a9385b68fd8c75,2021-07-07 17:02:20+02:00,Normal,34856,34856,394875,394868,1309,689.0,7,963,0,180
77b88fe621bb7828535a4c4cf37d9d4ac01b146b,5013798fe9a87b693ddb5589a8a408a04a873781,2021-07-08 06:51:10+02:00,Normal,34856,34856,394877,394875,1310,690.0,2,965,0,180
7bb0605a8c4adb4247a179276036f138ae859ac9,90ba716bf060ee7fef79dc230b0b20644839069f,2021-07-08 13:13:40+02:00,Normal,34918,34918,395295,395293,1310,691.0,2,967,0,180
ae32e337e0fd7547cce9bce04be1cf256e0a7bd5,7bb0605a8c4adb4247a179276036f138ae859ac9,2021-07-09 07:38:31+02:00,Normal,34918,34918,395296,395295,1311,692.0,1,968,0,180
0250340e372f652c4f276e6874d452d683c94dfe,013a1824d3c57b7ffc5240bc03d219a4a290aa3d,2021-07-12 11:46:37+02:00,Normal,34957,34957,395515,395519,1314,693.0,-4,964,0,180
37e8367c359cd115f109d82f99ff32be219f4928,1f4908b01aaf7b209521d40ca0f3eb48f2ef1988,2021-07-13 20:21:22+02:00,Normal,34957,34957,395596,395597,1315,694.0,-1,963,0,180
a56531ab1b772ee4ae94dd805f168761887354c6,f6d3557aa13f33cfe2fa41094fc3d8a8b09c368c,2021-07-15 20:42:17+02:00,Normal,35008,35008,395835,395835,1317,695.0,0,963,0,180
83022d279c585be2c4173b36a92d4399e738150e,c35b81b864ffa84751bac7d73046840f576491f9,2021-07-22 09:42:07+02:00,Normal,35059,35059,396309,396276,1324,696.0,33,996,0,180
11879530a34616e6dfa4186fef783d9fce0dac28,5a634a7b6f248e5dead65f420ec5d30acd9724bf,2021-07-27 07:05:46+02:00,Normal,35101,35101,396748,396748,1329,697.0,0,996,0,180
01eed041555e92ec15b8041ee552932119265464,4c6a6d5ac7aa348d5b4b9a4d6bb7cc18af49f72a,2021-07-29 11:54:14+02:00,Normal,35104,35104,396973,396973,1331,698.0,0,996,0,180
f331eba6d576752dd79c4b37c41d981daa537fe6,7c30bdbdb16204970cc320f4345b8a439d8f65b4,2021-07-29 19:11:42+02:00,Normal,35104,35104,396965,396965,1331,699.0,0,996,0,180
caa2dd08c4722c8702588f5dfe1fa4c506aa66fc,6f5e07a84d65496abcdb876170c513c4a3840760,2021-07-30 10:52:43+02:00,Normal,35095,35095,396954,396954,1332,700.0,0,996,0,180
228ec8e015bac9751c8aef3107358fbb2cb3301b,caa2dd08c4722c8702588f5dfe1fa4c506aa66fc,2021-07-30 11:02:44+02:00,Normal,35095,35095,396954,396954,1332,701.0,0,996,0,180
f2ed2211c26ba375390cb76725c95ae970a0fd1d,228ec8e015bac9751c8aef3107358fbb2cb3301b,2021-07-30 11:02:48+02:00,Normal,35095,35095,396954,396954,1332,702.0,0,996,0,180
34d5336b9deed41c6b61989f8cd755e9d179ce4c,f03ba0ad52e6f1deb42f022090f226573b22f630,2021-08-02 11:37:39+02:00,Normal,35095,35095,396946,396945,1335,703.0,1,997,0,180
52f9cfee9fbe9e19faf8a44e1063da8a3ec07ea7,7afca03c4058c25f2e1cec8d0b07c2157c93e831,2021-08-04 09:20:26+02:00,Normal,35097,35097,397152,397150,1337,704.0,2,999,0,180
ab16507f192d6da371f7165ecb159764a807cadc,2d0ae8da80e1ed37e94f3abad5c80145a00e688f,2021-08-05 05:55:35+02:00,Normal,35107,35101,397263,397240,1338,705.0,23,1022,6,186
61d92c650f5bc363177ebace62e3e8a67ec9499d,5d4f21b16f002ed5202a68d6977346ccf53b0b0e,2021-08-06 12:58:55+02:00,Normal,35099,35099,397340,397337,1339,706.0,3,1025,0,186
65ed96fa394f3d9d548c6d9d8144bbb51c4c68ff,b2be7e12cce8e62eeee512fbea4a32503d048120,2021-08-09 13:42:26+02:00,Normal,35097,35097,397391,397389,1342,707.0,2,1027,0,186
b64db05b9cedd96905d637a2d824cbbf428e40e7,f0776a558c4bee8524aa698c8dbe36790918152b,2021-08-09 19:23:29+02:00,Normal,35097,35097,397395,397399,1342,708.0,-4,1023,0,186
54a30a7a00fea6c5e3702282ade6e0238e06de3b,3a6431db5461b88e691d770abdba6a2793ef699d,2021-08-11 09:01:14+02:00,Normal,35097,35097,397463,397461,1344,709.0,2,1025,0,186
c2a5735d8679c4d07ceb667cc5418f64ee372b60,5092f7247de8d3aa2fdb762e50f5ac2aa4e6f6e0,2021-08-19 09:18:32+02:00,Normal,35099,35088,397591,397528,1352,710.0,63,1088,11,197
36714be874fa9ba7c0229d97607906669615e409,c2a5735d8679c4d07ceb667cc5418f64ee372b60,2021-08-19 09:18:32+02:00,Normal,35124,35099,397617,397591,1352,711.0,26,1114,25,222
d7394cfa13a4d1a02356e3a83e10ec100fbb9948,b263f4b69db4093847ccc3b85e51cc7f3759e42c,2021-08-24 16:16:44+02:00,Normal,35113,35113,397715,397715,1357,712.0,0,1114,0,222
fa1d7ba5b9c7707cae4a23ce9876c0a7abd924a5,7ea86076fc1128d43b47f4826cb25eb5ebb19f19,2021-08-26 07:49:37+02:00,Normal,35139,35143,398178,398175,1359,713.0,3,1117,-4,218
a5cb1ef6eb842c38627ff6685b977fd42a342b67,3445c50a3affc5ae7b1c2712a139d4a5105aeaf5,2021-08-27 06:12:53+02:00,Normal,35139,35139,398178,398178,1360,714.0,0,1117,0,218
93e06f29787fce6f7c58acd9d1e17a7192a66c94,2c912c348808ee66a4fd164bda68b494243c6c54,2021-08-31 10:37:59+02:00,Normal,35209,35209,398410,398426,1364,715.0,-16,1101,0,218
1eb3f500a44b08a05868cd8bd85501dd6c7ee6c7,b667ac24ead73300c49e265201b6c0b913ee36a3,2021-08-31 13:43:10+02:00,Normal,35215,35209,398552,398517,1364,716.0,35,1136,6,224
f3a0dc5b2a0e5ef6fa2ae896ede6a7d56e20653b,1eb3f500a44b08a05868cd8bd85501dd6c7ee6c7,2021-09-01 07:40:01+02:00,Normal,35215,35215,398552,398552,1365,717.0,0,1136,0,224
af10e97531a59e4af09b5ec0c1a3ea476f2b6015,f3a0dc5b2a0e5ef6fa2ae896ede6a7d56e20653b,2021-09-01 09:48:32+02:00,Normal,35215,35215,398552,398552,1365,718.0,0,1136,0,224
f65eb4664603fd66d638b78c670da12b00f6b907,eeed488a3439c5c5c3f0b5991ee400851057e127,2021-09-01 20:54:12+02:00,Normal,35231,35231,398659,398659,1365,719.0,0,1136,0,224
338fc0e7f10f7ca781b059f2ff46e1a1a85c91f8,f65eb4664603fd66d638b78c670da12b00f6b907,2021-09-01 20:54:12+02:00,Normal,35231,35231,398682,398659,1365,720.0,23,1159,0,224
50ed545e2fa02c51e0d1559b83624f256e4b499b,d0ea01af2814e276c4a090e599d5fd11c6ce4bf8,2021-09-02 10:56:56+02:00,Normal,35233,35233,398705,398708,1366,721.0,-3,1156,0,224
ec2f6ea9c6203524933e08d069733cd00a09ede3,3921b1c6d24c9d5a60e5f5f83c9a394104089c21,2021-09-07 11:57:14+02:00,Normal,35257,35257,398816,398807,1371,722.0,9,1165,0,224
4a43335d300da942602fbf216cd0a53b60827ab4,301a85a12f3c2c9427c7ff581fd4683bab1f29f6,2021-09-08 08:37:27+02:00,Normal,35290,35309,399106,399072,1372,723.0,34,1199,-19,205
6426c3077c8048bb3fa5bfcec6be80f73476b534,ec212c66167759a2a40b13d5efc47d883816d4da,2021-09-16 07:12:58+02:00,Normal,35345,35345,399932,399928,1380,724.0,4,1203,0,205
f1bcaa9be8227dce89a320ce1ca37e1df7c80d03,306607d5b99b6eca6ae2c1e726d8eb32b9b2ca1b,2021-09-16 20:20:54+02:00,Normal,35379,35379,400165,400158,1380,725.0,7,1210,0,205
b5bf026813ca9aff83243f901edd722e0d60c2ea,fc91ea1e50e5ef207f0f291b3f6c1942b10db7c7,2021-09-17 08:56:16+02:00,Normal,35379,35379,400158,400158,1381,726.0,0,1210,0,205
ef4ef3b8f5e253f009d27952a4e75e008c9d6e5f,0a9aa02e6f1d1b9ceca155d281a2be624bb1d3a2,2021-09-20 06:54:35+02:00,Normal,35377,35377,400535,400535,1384,727.0,0,1210,0,205
01042c46f08e243af996103fb3a2cf31fbb27599,456466d932830b096d39806e291fe23ec5ed38d5,2021-09-20 20:07:23+02:00,Normal,35380,35380,400962,400962,1384,728.0,0,1210,0,205
32f052be0a64fc9e4690618c4fc942210c72f343,01042c46f08e243af996103fb3a2cf31fbb27599,2021-09-20 20:50:07+02:00,Normal,35380,35380,400962,400962,1384,729.0,0,1210,0,205
c1689e65ffc64611bdc093baa5b767a18afea409,32f052be0a64fc9e4690618c4fc942210c72f343,2021-09-20 20:55:10+02:00,Normal,35380,35380,400962,400962,1384,730.0,0,1210,0,205
e2be307b3ab6ebf339b3a765fe64967c9602266f,75d6c4ae6df93c4c4d8621aced3a180afa18a6cb,2021-09-20 21:23:01+02:00,Normal,35324,35324,400569,400615,1384,731.0,-46,1164,0,205
32b7ffc2bbfd1ae055bdbe287f8598de731adce1,8b6d0333cf5cfefd55e36969145507bb6acfca10,2021-09-20 21:23:01+02:00,Normal,35324,35324,400397,400397,1384,732.0,0,1164,0,205
8b6d0333cf5cfefd55e36969145507bb6acfca10,737fa72ae3de1debe97f0a527eeebda3869aa227,2021-09-20 21:23:01+02:00,Normal,35324,35324,400397,400403,1384,733.0,-6,1158,0,205
737fa72ae3de1debe97f0a527eeebda3869aa227,05f3a6186efefc9fca2204a745b992501c6fd91f,2021-09-20 21:23:01+02:00,Normal,35324,35324,400403,400433,1384,734.0,-30,1128,0,205
05f3a6186efefc9fca2204a745b992501c6fd91f,e2be307b3ab6ebf339b3a765fe64967c9602266f,2021-09-20 21:23:01+02:00,Normal,35324,35324,400433,400569,1384,735.0,-136,992,0,205
75d6c4ae6df93c4c4d8621aced3a180afa18a6cb,d25710a625fbb6dbb047c159417f796102fd721a,2021-09-20 21:23:01+02:00,Normal,35324,35362,400615,400802,1384,736.0,-187,805,-38,167
1cb495074f6d983096a015736fed16176588cd33,2e10abeb7f375d56dca21b1baed11f98e74ab7f5,2021-09-20 21:23:01+02:00,Normal,35362,35380,400871,400924,1384,737.0,-53,752,-18,149
a7dc745ee560c3833b095e74a86978928b89a441,c1689e65ffc64611bdc093baa5b767a18afea409,2021-09-20 21:23:01+02:00,Normal,35380,35380,400962,400962,1384,738.0,0,752,0,149
810bca5a1ae33a9c8b54a2a516aa5bb8ec013c3f,a7dc745ee560c3833b095e74a86978928b89a441,2021-09-20 21:23:01+02:00,Normal,35380,35380,400962,400962,1384,739.0,0,752,0,149
d25710a625fbb6dbb047c159417f796102fd721a,1cb495074f6d983096a015736fed16176588cd33,2021-09-20 21:23:01+02:00,Normal,35362,35362,400802,400871,1384,740.0,-69,683,0,149
2e10abeb7f375d56dca21b1baed11f98e74ab7f5,97237ad3feed80407ed1884ea84cf00fd9fea367,2021-09-20 21:23:01+02:00,Normal,35380,35380,400924,400962,1384,741.0,-38,645,0,149
97237ad3feed80407ed1884ea84cf00fd9fea367,810bca5a1ae33a9c8b54a2a516aa5bb8ec013c3f,2021-09-20 21:23:01+02:00,Normal,35380,35380,400962,400962,1384,742.0,0,645,0,149
1d16dbc74563ec9aeb4bdff870d0fe5064667b26,f8bab4e0dcdad5cb174998e1b31d74c8434a2477,2021-09-21 09:27:44+02:00,Normal,35324,35324,400399,400399,1385,743.0,0,645,0,149
f8bab4e0dcdad5cb174998e1b31d74c8434a2477,8eb56930915f8022aa27ec29ab5be7d21764608c,2021-09-21 09:27:44+02:00,Normal,35324,35324,400399,400399,1385,744.0,0,645,0,149
881a4799114fccefbc0f56c6524110ede2682e16,1d16dbc74563ec9aeb4bdff870d0fe5064667b26,2021-09-21 10:16:44+02:00,Normal,35324,35324,400409,400399,1385,745.0,10,655,0,149
1bb8200f2f900a0cb200adfb0b0e11ec6f69fdd2,881a4799114fccefbc0f56c6524110ede2682e16,2021-09-21 10:19:14+02:00,Normal,35324,35324,400409,400409,1385,746.0,0,655,0,149
7d909b2282c91c5bc5204dd160412e90fa86d624,2f0f30f973363a59c20f204f9351724fb2ce7327,2021-09-21 13:40:07+02:00,Normal,35326,35326,400447,400447,1385,747.0,0,655,0,149
221b2f85febcf68629fc3a4007dc7edb5a305b91,2f144323756fc6f8517e357c540f3570356d9eba,2021-09-22 11:57:54+02:00,Normal,35326,35326,400454,400457,1386,748.0,-3,652,0,149
48924966e275670623bd7e33e9089f895f6a3110,448d974d9646b96806ef07a9ceeceb96e4bac645,2021-09-22 13:11:37+02:00,Normal,35340,35340,400544,400544,1386,749.0,0,652,0,149
3b9fe906bf28d2e748ce4d9a1af5fbcd5df48946,3f2170f720fe1e2b1030887684c18dc2fc20116b,2021-09-23 10:36:30+02:00,Normal,35340,35340,400541,400544,1387,750.0,-3,649,0,149
5bac1719a2fcbee5cb8b9e22c3480e3a24ed6c4c,840ad06300ac38e0e0e18ea36d6969cc03c875a9,2021-09-27 09:10:58+02:00,Normal,35350,35350,400661,400661,1391,751.0,0,649,0,149
fb05ca420da1341c0d39cf1f0e2fb659be836c92,5bac1719a2fcbee5cb8b9e22c3480e3a24ed6c4c,2021-09-27 09:55:02+02:00,Normal,35350,35350,400660,400661,1391,752.0,-1,648,0,149
93f3b7a0ba2969109940775a18515728603afac6,f5a3243911a5c42775cd838a3da1d0f3ac4a74ee,2021-09-28 10:57:16+02:00,Normal,35350,35350,400692,400692,1392,753.0,0,648,0,149
903aaa35e5ceaa33bfc9b19b7f6da65ce5a91dd4,dd1fa3a31b4680c0d3712e6ae122b878138580c7,2021-09-30 11:26:17+02:00,Normal,35356,35356,400803,400793,1394,754.0,10,658,0,149
15987c9c5315ac30f069915e28de78ade788458d,c113f7fb0dae0dfd066d05acd1032c9f57a5aaf9,2021-10-05 09:59:10+02:00,Normal,35363,35363,401170,401170,1399,755.0,0,658,0,149
604df4e0adc71da264f61fe85020a170c98e6f09,a31edf43b67143f41351ebe53d036f655c643f7a,2021-10-05 13:30:41+02:00,Normal,35363,35363,401170,401170,1399,756.0,0,658,0,149
01bf679e59850bb7b3e6395f1683bd1463ed9969,bf4be3711acfbfc765fb17dc238b1b9bbad5b7be,2021-10-08 15:51:04+02:00,Normal,35415,35415,401309,401301,1402,757.0,8,666,0,149
f2a28e11d910f2aba67f62ad2d7870d24b4ce24b,01bf679e59850bb7b3e6395f1683bd1463ed9969,2021-10-11 09:03:15+02:00,Normal,35415,35415,401309,401309,1405,758.0,0,666,0,149
5b0f1f95d064b6fa32192a68d6c5dd14403001c4,5e68bffba53625fe3ddbb461d0611060346f8ba3,2021-10-11 20:52:58+02:00,Normal,35415,35415,401314,401314,1405,759.0,0,666,0,149
5e68bffba53625fe3ddbb461d0611060346f8ba3,7872971dfbb818177168e64c24a933e48ce01206,2021-10-11 20:52:58+02:00,Normal,35415,35415,401314,401314,1405,760.0,0,666,0,149
da266b3c5ca4bb7581d7a3cc51bc820e78cf64f0,5b0f1f95d064b6fa32192a68d6c5dd14403001c4,2021-10-12 06:21:14+02:00,Normal,35415,35415,401354,401314,1406,761.0,40,706,0,149
e43a131887e2a316d4fb829c3a272ef0cbbeea80,d10c7bfe56f025ccc690721c9f13e7029b777b9c,2021-10-12 15:16:00+02:00,Normal,35440,35440,401463,401463,1406,762.0,0,706,0,149
409060780cc7ac1f7cfbdff1f7197945a801cf77,32f1fe5f89bc9ae98161c07f3676f6aaedc8e877,2021-10-12 20:38:36+02:00,Normal,35445,35445,401533,401533,1406,763.0,0,706,0,149
94beb679a6448e2d88f9e088151a1af2e859d6de,30d8932753cd0e414469f8da7ebe21e963737273,2021-10-14 06:04:56+02:00,Normal,35445,35445,401533,401533,1408,764.0,0,706,0,149
cdad96e6330cd31185f7496aaf8eb316f2773d6d,f345c9fb3e6bcc1ad78fead35fc17eaf8133fed5,2021-10-14 11:36:51+02:00,Normal,35444,35449,401582,401619,1408,765.0,-37,669,-5,144
569a33579c3cca5f801c544d9b52a34e3c779424,e567670b1abe61af4acfaa6a6a7e92a7acfa8b00,2021-10-15 09:58:35+02:00,Normal,35464,35459,401793,401819,1409,766.0,-26,643,5,149
fd881e8cd9b7686ab8fcd32332100710a8ffaa10,5896aa8367d545c60bb544c31d7ecaaecc321045,2021-10-19 13:05:13+02:00,Normal,35471,35471,401878,401878,1413,767.0,0,643,0,149
9231526af4b9825583b0d3cb943f88109fd30551,1405dc78872f9d18180feebb4f2c57dbe1259acb,2021-10-21 20:23:58+02:00,Normal,35478,35478,402343,402339,1415,768.0,4,647,0,149
d446f8ba0820c8a4a923614611ae53582d38bc8e,def09bf4126d4886413adf7388882eca8e32576b,2021-10-26 08:46:50+02:00,Normal,35481,35481,402533,402535,1420,769.0,-2,645,0,149
8e3b1cf098018b4632de63c359ef6d761e92ec04,afeafd6036616bac8263d762c1610f22241c0187,2021-10-28 16:08:59+02:00,Normal,35473,35473,402561,402565,1422,770.0,-4,641,0,149
7ec603ba259083298c9598a41987b4c4f2a5d134,125f9afc2c42449ee79283fefa778651acfd4aed,2021-11-01 10:18:49+01:00,Normal,35473,35473,402586,402586,1426,771.0,0,641,0,149
d811fa1d1012e746719aa3af351f56ad21f92610,7ec603ba259083298c9598a41987b4c4f2a5d134,2021-11-01 10:41:06+01:00,Normal,35473,35473,402586,402586,1426,772.0,0,641,0,149
c3e0dfe4cc673fb0f9a0fe9d90acd54ebe6f8ced,d811fa1d1012e746719aa3af351f56ad21f92610,2021-11-02 07:03:11+01:00,Normal,35473,35473,402586,402586,1427,773.0,0,641,0,149
dab48b7482295956973879d15bfd4d3bb0718772,c069ee0b9dd823899bd7095deadf167cd426c0b7,2021-11-02 15:34:08+01:00,Normal,35476,35476,402626,402601,1427,774.0,25,666,0,149
60503cc747eeda7c61bab02b71f8f55a733a6eea,95a4db3fbd946dd56f46f4c8c22be3b28083d845,2021-11-04 10:46:01+01:00,Normal,35493,35493,402909,402909,1429,775.0,0,666,0,149
ba9ced3e9a643a05bc521f0a2e6d02e3569de374,c6c6cd3c5ad9c36795bb120e521590424f034ae4,2021-11-05 12:11:18+01:00,Normal,35461,35493,402976,403065,1430,776.0,-89,577,-32,117
6bc437c0d82675ebe6aa92c8e249892205c316ef,948d6d880500bc925e23fde29e0f7ff7cc52cac5,2021-11-09 09:03:40+01:00,Normal,35478,35493,403284,403243,1434,777.0,41,618,-15,102
0b95a96ee10d3e12aef01d449467bcf4641286b4,afea68ca51c20b726d3b97aaffdfe4e3b632e435,2021-11-10 16:38:43+01:00,Normal,35478,35478,403205,403283,1435,778.0,-78,540,0,102
adb4100e58d9ea073ee8caa454bb7c885b6a83ed,661316b066923493ff91d6d2aa92e463f595a6b1,2021-11-12 09:36:18+01:00,Normal,35490,35490,403302,403314,1437,779.0,-12,528,0,102
f0480ddd2d3cb04b784cf7ea697f792b45c689cc,2d124f6a1c45afdde8be90c01043e0b14455d41e,2021-11-17 12:31:25+01:00,Normal,35490,35490,403302,403296,1442,780.0,6,534,0,102
8b020f2e64f1cbf2b06205a389a13af6623f90ce,e6e664a71130ee74d2c4c6800e4131f132709997,2021-11-22 12:34:32+01:00,Normal,35496,35496,403450,403450,1447,781.0,0,534,0,102
a17becf4c7f4e4057e8c94990e4b4999be0aea95,8b020f2e64f1cbf2b06205a389a13af6623f90ce,2021-11-23 07:04:04+01:00,Normal,35496,35496,403450,403450,1448,782.0,0,534,0,102
1555e5850df0a442154e2ce5e54d47bbb013ff66,7f8f69fb38247827220805f18c2e0f08406d8a3b,2021-11-24 10:23:43+01:00,Normal,35496,35496,403465,403466,1449,783.0,-1,533,0,102
e361621dbc77b5d926ec4deff5e7c792a61db71e,51c24d8799fb09f04d0a5deb713eaeceb20d15c7,2021-11-25 20:08:46+01:00,Normal,35503,35503,403540,403544,1450,784.0,-4,529,0,102
75ee7057e98dd9725fabb98cabe42966fa4c8222,24b316536a7ee4c54a54f632de1852aecb4038c0,2021-11-26 11:16:35+01:00,Normal,35503,35503,403590,403590,1451,785.0,0,529,0,102
ae4077e13ea2e4c460c3f21b9aab93a696590851,322a1a037d4d2f18744c5d1a1efc2e84d4c5e94b,2021-11-30 11:25:00+01:00,Normal,35567,35567,404029,404029,1455,786.0,0,529,0,102
5def7f3f743d0bb178546586245ad88a84b69390,d75c387f46c55459a2daf071e5463bad0ad7dcbd,2021-12-02 11:27:29+01:00,Normal,35559,35559,404274,404274,1457,787.0,0,529,0,102
2c7846d992ca512d36a73f518205015c88ed088c,9c1fe446b620963209df03b2fab1b3b9b5dc1988,2021-12-03 11:56:22+01:00,Normal,35564,35558,404307,404268,1458,788.0,39,568,6,108
4f7bbc61386ec89bf664905609ae6e93e41bd6bf,2c7846d992ca512d36a73f518205015c88ed088c,2021-12-03 12:03:30+01:00,Normal,35564,35564,404318,404307,1458,789.0,11,579,0,108
d3a64bea51676fcf8a0ae593cf7b103939e12c87,d3f4c2b95d2a13a5d9bc0e6413dfdbab21388822,2021-12-04 15:55:03+01:00,Normal,35564,35564,404331,404326,1459,790.0,5,584,0,108
628b6a686974698cbf820bad72f10dad133174ec,1eaf38fa87384fe26d1abf6e389d6df1600d4d8c,2021-12-06 20:31:03+01:00,Normal,35572,35564,404373,404358,1461,791.0,15,599,8,116
8747052411275d290b2152ffcb8dee11afbb82cd,d4dcd5b9dd9e462fec8220e33e3e6c822b7e88a6,2021-12-07 08:51:26+01:00,Normal,35572,35572,404390,404390,1462,792.0,0,599,0,116
513441240f874dd0b6187c0c6aaa3e8eccd8ddbe,da7062be455e05bf4836f9462d79437a704f114f,2021-12-07 09:49:39+01:00,Normal,35572,35572,404388,404388,1462,793.0,0,599,0,116
d7bd9eb6cda0aff4634cbb453622b24a98933463,513441240f874dd0b6187c0c6aaa3e8eccd8ddbe,2021-12-07 10:02:41+01:00,Normal,35572,35572,404388,404388,1462,794.0,0,599,0,116
adef3d975e55c55b020c2f357d82c2db11e58450,d7bd9eb6cda0aff4634cbb453622b24a98933463,2021-12-07 10:41:32+01:00,Normal,35572,35572,404388,404388,1462,795.0,0,599,0,116
974e3b8750fe96c16c9c0b115a72ee4a2171df34,17df72114e222d63c2af9ed9780583f4cb0689eb,2021-12-09 20:24:38+01:00,Normal,35578,35578,404651,404652,1464,796.0,-1,598,0,116
4e249d11a6e56ca8feb4b055b681cec457ef3a3d,702c314c57b4c5ea762fa71fe5856b8f586dcc65,2021-12-10 12:05:58+01:00,Normal,35578,35578,404667,404664,1465,797.0,3,601,0,116
57f0638573c04ae54350bff7859d75b0410121aa,4e249d11a6e56ca8feb4b055b681cec457ef3a3d,2021-12-10 12:06:46+01:00,Normal,35578,35578,404668,404667,1465,798.0,1,602,0,116
2f73e5406d54cb8945e187eff302a3a3373350be,57f0638573c04ae54350bff7859d75b0410121aa,2021-12-10 17:13:05+01:00,Normal,35578,35578,404678,404668,1465,799.0,10,612,0,116
c66ecc556883e569fb328b5d7258b17d660c2266,75485d16a289c1fc4eb39702c14d2f08f0d8ccce,2021-12-13 11:28:35+01:00,Normal,35574,35578,404725,404691,1468,800.0,34,646,-4,112
5de12a369a7b2231e668e0460c551c504718dbf6,ac5cc6cf01463d90aa333d5f6f046c311019827b,2021-12-15 18:54:02+01:00,Normal,35580,35580,404949,404949,1470,801.0,0,646,0,112
882647a82cebb97cd786a08c013714cfea9c1aed,5de12a369a7b2231e668e0460c551c504718dbf6,2021-12-16 06:35:44+01:00,Normal,35520,35580,404917,404949,1471,802.0,-32,614,-60,52
40165eecc40f9e223702a41a0cb0958515bb1f82,068b2c072b0d28cbd5ea63811779629cdaad8638,2021-12-16 20:13:17+01:00,Normal,35520,35520,404995,404957,1471,803.0,38,652,0,52
ca04659b4b3f042c1bc7e557c25ed91e3c56c745,c4328c2f4e958c13dbe1ff47368f06982dfa59b2,2021-12-22 20:32:55+01:00,Normal,35539,35539,405270,405276,1477,804.0,-6,646,0,52
2d07e1aaebadbd576ee2a055760a5866d4408a87,59a66f05126a4f9622f67ac71ccc149c805a6ccd,2021-12-27 18:49:19+01:00,Normal,35556,35551,405806,405737,1482,805.0,69,715,5,57
ad6bb20557f5c87de26aeb3afb061af942a8cc17,b13d920b7b56d3e088e35311f5ee54f25d2779af,2021-12-28 12:36:57+01:00,Normal,35556,35556,405806,405806,1483,806.0,0,715,0,57
361bb8f786f112ee275be136795c0b1ecefff928,d5f2d5d6041d477fc8f5fc53c20112e07ef104fc,2021-12-29 10:57:23+01:00,Normal,35556,35556,405805,405806,1484,807.0,-1,714,0,57
1283458baae482c2bbb22c842b1db6c832c953f3,aecfc40c88ce19aa0b830ee2d3d2077b304757bc,2021-12-30 08:38:04+01:00,Normal,35558,35558,405865,405865,1485,808.0,0,714,0,57
826701232c4d82ddf1fe0fd073a1a9f3316d2061,eb901681ab58c008f7bbbe555e5f43f8e0893bd3,2021-12-30 12:42:37+01:00,Normal,35558,35558,405859,405865,1485,809.0,-6,708,0,57
a21a63cc288ba51bcf8c227a49de6f5bb9a72cc3,826701232c4d82ddf1fe0fd073a1a9f3316d2061,2021-12-30 13:19:25+01:00,Normal,35558,35558,405836,405859,1485,810.0,-23,685,0,57
4400d8568ad5695c46e8de45635a82a27a26b871,a21a63cc288ba51bcf8c227a49de6f5bb9a72cc3,2021-12-31 06:49:10+01:00,Normal,35558,35558,405836,405836,1486,811.0,0,685,0,57
30613d6a748fce18919ff8b0da166d9fda2ed9bc,0ab58c120939093fea90822f376e1866fc714d1f,2022-01-04 05:50:00+01:00,Normal,35558,35558,405873,405856,1490,812.0,17,702,0,57
7346c288e307e1821e3ceb757d686c9bd879389c,4c60c3edff4312303e1021fca47ed52c2152d285,2022-01-07 16:29:15+01:00,Normal,35628,35628,406359,406359,1493,813.0,0,702,0,57
b0ccf74549fe138c040798e0e99fc0291a7e03ed,3d7ac6420c0ff23305bc50c69c419c4ed5d2a838,2022-01-10 13:30:24+01:00,Normal,35614,35614,406362,406362,1496,814.0,0,702,0,57
178109c1734ccc16386c3e3cbae1465c7a1b8ed8,b0ccf74549fe138c040798e0e99fc0291a7e03ed,2022-01-10 13:30:24+01:00,Normal,35614,35614,406362,406362,1496,815.0,0,702,0,57
b111b15c12bb89c49006ea13d20435d2022db23a,fa235004dd1423b129befe847bbf207808ca07ad,2022-01-11 11:09:08+01:00,Normal,35628,35628,406512,406514,1497,816.0,-2,700,0,57
76aefe0fc918f81abaf638464c062507b2185cfd,18a15bbc9c7df19fe38f252bcd62d5a3811e3451,2022-01-12 11:21:51+01:00,Normal,35630,35630,406519,406519,1498,817.0,0,700,0,57
0a4a5e5bacc354df3132d0fcf706839c21afb89d,6815da6e9497a9a630d9f3637a51134d868bcd5b,2022-01-13 10:10:48+01:00,Normal,35664,35656,406580,406562,1499,818.0,18,718,8,65
30a01441347d5a2146af2944b29778fa0834d4be,f37face331f21cb8af70fc4ec101ec7b6be1f63e,2022-01-17 18:01:07+01:00,Normal,35670,35668,406670,406626,1503,819.0,44,762,2,67
4a8ac604b190084aea91c4d627715a833171feca,dc8bb35e39388d41b1f38b6c5d0181224e075f16,2022-01-19 16:03:04+01:00,Normal,35670,35670,406712,406703,1505,820.0,9,771,0,67
f605e85af9763a3940369bb79462f2cb466288f6,2c76c27a951ee76c6f763a05c7e119305a21c78d,2022-01-20 18:54:29+01:00,Normal,35705,35705,407204,407210,1506,821.0,-6,765,0,67
4ac0bf6acd6f82036a82f23705b14cce4ab28cb0,89d137f3be1685dfc2ce0968835c73667bffb0ba,2022-01-24 11:54:41+01:00,Normal,35737,35737,407423,407422,1510,822.0,1,766,0,67
eeca9342381c8583be16f18942774e785ab7e527,edbf930287cb72e9afab1f7208c24b1146b0c4ec,2022-01-25 07:21:57+01:00,Normal,35737,35737,407482,407482,1511,823.0,0,766,0,67
34aba9c06e3be7dd412586a871d755b7f9dcc54e,eeca9342381c8583be16f18942774e785ab7e527,2022-01-25 10:57:05+01:00,Normal,35737,35737,407482,407482,1511,824.0,0,766,0,67
f38c3cbadcb2b1bf77057cdbe89b06ca7bb71016,f97401d1b184406d2e24f11eddbdaca8bbc360e3,2022-01-26 17:47:03+01:00,Normal,35737,35737,407505,407488,1512,825.0,17,783,0,67
2eed554c3fd75dae1beade79f357ffd18d3c4fdf,d15a10afb51619faf14e678deae7dcda720413d9,2022-01-26 21:14:13+01:00,Normal,35743,35743,407515,407514,1513,826.0,1,784,0,67
e972620ada4f9ed7bc57f28e133e85c85b0a7b20,2eed554c3fd75dae1beade79f357ffd18d3c4fdf,2022-01-27 18:51:39+01:00,Normal,35753,35743,407584,407515,1513,827.0,69,853,10,77
67db54a5a7e0f1c2aa395e1db51214d09ae41f3f,c5c7a15b09368a58340d3a65ba9d1f1441e92dc8,2022-01-29 11:59:08+01:00,Normal,35787,35787,407723,407706,1515,828.0,17,870,0,77
71e7c8e73712419626f1c2b6ec036e8559a2d667,beb7ddbcee03270e833b2f74927ccfc8027aa693,2022-01-31 11:33:24+01:00,Normal,35787,35787,407754,407740,1517,829.0,14,884,0,77
fc18f36c4ab94399366ca2f2007b3692559a6f23,394517f07886495efcf79f95c7ee402a9437bd68,2022-02-01 07:41:40+01:00,Normal,35797,35787,407836,407814,1518,830.0,22,906,10,87
9e0df0d6dde441dbbad2b548d777e0a01d633286,fc18f36c4ab94399366ca2f2007b3692559a6f23,2022-02-01 08:17:25+01:00,Normal,35797,35797,407836,407836,1518,831.0,0,906,0,87
ba4a6880d1783190de4081bd456d934beb45cb19,9e0df0d6dde441dbbad2b548d777e0a01d633286,2022-02-01 09:10:20+01:00,Normal,35797,35797,407836,407836,1518,832.0,0,906,0,87
ca88caa1031c0de545d82de8d90dcae0e03651fb,0dcd549bbe36c060f536ec270d34d9e7d4b8e6c7,2022-02-01 15:11:35+01:00,Normal,35803,35803,408198,408065,1518,833.0,133,1039,0,87
c5cd8783825b5f6384417dac5f3889b4210b7d08,c9d6e3595cfd0aa58cde1656bd735ecfcd7a872b,2022-02-03 11:20:46+01:00,Normal,35802,35803,408225,408215,1520,834.0,10,1049,-1,86
11661d3815f273a6968cf09ecc678cf6fa6dcfcd,4b8e9492d9003ca357a4402f831112dd72efd2f8,2022-02-03 20:09:12+01:00,Normal,35822,35822,408275,408275,1520,835.0,0,1049,0,86
4b97f698db91854eebbed32f2ac210221a24f440,11661d3815f273a6968cf09ecc678cf6fa6dcfcd,2022-02-04 20:11:13+01:00,Normal,35822,35822,408275,408275,1521,836.0,0,1049,0,86
6f185a53a2a7acad0ad8383267942d554527688a,25514b604a64686ba603bf10a8a63390dc38b79d,2022-02-07 20:34:21+01:00,Normal,35822,35822,408286,408275,1524,837.0,11,1060,0,86
f68fa8b45dfac545cfc4111d4e52804c86db68d3,cf5e61cf6c721121abf7347baff3d41a0ad3c23e,2022-02-07 20:36:04+01:00,Normal,35822,35822,408287,408286,1524,838.0,1,1061,0,86
7119f40c9881666b6f9b5cf7df09ee1d21cc8344,9c19aff7c7561e3a82978a272ecdaad40dda5c00,2022-02-07 20:37:05+01:00,Normal,36566,36568,454682,451580,1524,839.0,3102,4163,-2,84
b9fee0f849a88091fb0615dd433b9e54f05b32c5,7119f40c9881666b6f9b5cf7df09ee1d21cc8344,2022-02-08 07:14:51+01:00,Normal,36566,36566,454682,454682,1525,840.0,0,4163,0,84
3702819227fd0cdd9b581cd99e11d1561d51cbeb,d113b5a837f726d1c638d76c4e88445e6cd59fd5,2022-02-11 22:21:58+01:00,Normal,36618,36618,454987,454957,1529,841.0,30,4193,0,84
d4c9dab74bc29c240c33879a1167e5fd0971c7bc,d84cd91e90cb0871e43f98cba8c53be99053e903,2022-02-15 10:16:06+01:00,Normal,36604,36604,454965,454962,1532,842.0,3,4196,0,84
1e2e1be02bdf0fe4add0d0279dbca1d74ae28ad7,35c2474f168fd10ac50886024d5879de81be5bd3,2022-02-16 21:09:24+01:00,Normal,36613,36606,455045,455016,1534,843.0,29,4225,7,91
1299bc33e131a3c44b544b58c706bc998c4228ed,fe3518d25edd69b782339729080b0295a8a33952,2022-02-21 07:54:47+01:00,Normal,36608,36608,455228,455200,1538,844.0,28,4253,0,91
b626c5a9798b045b655d085d59efdd60b5d7a0e3,1299bc33e131a3c44b544b58c706bc998c4228ed,2022-02-21 09:46:39+01:00,Normal,36608,36608,455228,455228,1538,845.0,0,4253,0,91
d11944be3466ce8e874474949134811ed6e90e92,7fd2deb3e86a021b3108027d786d45657243532c,2022-02-23 07:29:15+01:00,Normal,36654,36648,455666,455637,1540,846.0,29,4282,6,97
aa8c36118c34a1d19680754aca18b22152f1099c,2b6a3baebe70e4d481dd256bdb774ac15e248540,2022-02-25 13:40:13+01:00,Normal,36673,36673,455853,455853,1542,847.0,0,4282,0,97
26c166c3b000ad829127046b1b107d9733a6a2ef,aa8c36118c34a1d19680754aca18b22152f1099c,2022-02-25 22:01:27+01:00,Normal,36673,36673,455888,455853,1543,848.0,35,4317,0,97
445b075def2c037b971518963b70ce13df5e88a2,119f227aa62885f12cd7dd2558a62148d02adbb4,2022-03-01 08:09:58+01:00,Normal,36658,36656,455925,455901,1546,849.0,24,4341,2,99
a46bc327e70f81b66800780edf3830f6137a89e3,b811364421c8eea0cf06459462cf1fd58184773b,2022-03-04 09:51:52+01:00,Normal,36670,36670,455996,455984,1549,850.0,12,4353,0,99
795da6306a048b18c0158496b0d49e8e4f197a32,a46bc327e70f81b66800780edf3830f6137a89e3,2022-03-04 11:21:05+01:00,Normal,36670,36670,455995,455996,1549,851.0,-1,4352,0,99
4468bcc6579402904763ffa74b4ab0e41a1cd316,f3bf6c4218404479f7841e0af213d5db65913278,2022-03-07 10:56:31+01:00,Normal,36691,36691,456277,456277,1552,852.0,0,4352,0,99
c121e32082edaff817d9f69dec0c24855dc0186f,4468bcc6579402904763ffa74b4ab0e41a1cd316,2022-03-07 13:17:58+01:00,Normal,36691,36691,456277,456277,1552,853.0,0,4352,0,99
d9fc383a5e0ad0a570fb2aa0387cabc648053c09,76fda7729e4cdfec715cd92b2c80d851797b05f7,2022-03-08 09:29:32+01:00,Normal,36691,36691,456310,456310,1553,854.0,0,4352,0,99
d4fd31684ad5a7b9be8a9d26c5a8796f96c8d80b,d9fc383a5e0ad0a570fb2aa0387cabc648053c09,2022-03-08 13:17:05+01:00,Normal,36691,36691,456310,456310,1553,855.0,0,4352,0,99
6ffe48b8e43140e79180ec6dc02577437e761819,8f7cda083154a2e97e07115a66ee28be27200348,2022-03-11 22:16:46+01:00,Normal,36689,36689,456408,456408,1557,856.0,0,4352,0,99
be80aa55ec120b3b6645b3efb77316704d7ad948,a88fab1bca33c037bd1a12459c215d7bc1247735,2022-03-15 13:07:44+01:00,Normal,36684,36689,456457,456467,1560,857.0,-10,4342,-5,94
3eaba13a476c14b75429ba34180184b81997b33a,be80aa55ec120b3b6645b3efb77316704d7ad948,2022-03-15 16:13:28+01:00,Normal,36684,36684,456457,456457,1560,858.0,0,4342,0,94
970f5bf5035d8c99b0ff883f984b60cf531dddbe,3b3f38b3b09b0f2373e51406ecb8c9c45d36aebc,2022-03-16 09:07:01+01:00,Normal,36684,36684,456602,456595,1561,859.0,7,4349,0,94
39ae8d740e30c18e46873cf82aff76588f1974c7,ba298a32b30eb270ea0bf4f8fc208223d0b40bcd,2022-03-17 11:10:03+01:00,Normal,36684,36684,456678,456678,1562,860.0,0,4349,0,94
fbacaa58ffc5a62456ee68b90efa13957f761ce4,39ae8d740e30c18e46873cf82aff76588f1974c7,2022-03-18 08:55:32+01:00,Normal,36684,36684,456678,456678,1563,861.0,0,4349,0,94
ed6db5354294b5492423027d60a60b787b6cdc42,fbacaa58ffc5a62456ee68b90efa13957f761ce4,2022-03-18 20:57:08+01:00,Normal,36684,36684,456679,456678,1563,862.0,1,4350,0,94
b07ee98b27e58992fdc10fec0ec67e68ae1d272d,4b8e4f506079419c7995107fad46416ee5add951,2022-03-19 15:41:48+01:00,Normal,36684,36684,456721,456721,1564,863.0,0,4350,0,94
653daaa60cf4de7071136541169285ed3d71974d,7325d291524827806feed271a077ea23e2b1b21f,2022-03-22 11:13:36+01:00,Normal,36684,36684,456762,456762,1567,864.0,0,4350,0,94
1b695fbbc203c163bf7b8d78f6313a6c506fb938,bb61f0186d5c490caa44f3e3672d81e14414d33c,2022-03-24 09:13:24+01:00,Normal,36672,36672,456799,456798,1569,865.0,1,4351,0,94
94d8ed55fa8e181b98f818a1b2805c66943cfeec,1b695fbbc203c163bf7b8d78f6313a6c506fb938,2022-03-24 17:41:53+01:00,Normal,36678,36672,456837,456799,1569,866.0,38,4389,6,100
1d9d082acf6e152c06833bb9698f88d688b95e40,94d8ed55fa8e181b98f818a1b2805c66943cfeec,2022-03-25 08:48:32+01:00,Normal,36678,36678,456861,456837,1570,867.0,24,4413,0,100
d44951b36ef2e698f32a8e1352671689e44c4d62,1d9d082acf6e152c06833bb9698f88d688b95e40,2022-03-25 10:29:59+01:00,Normal,36678,36678,456864,456861,1570,868.0,3,4416,0,100
abfdb4d7f384fb06ed9b7ca37b548542df7b5dda,379bb201ed346a76e322fe7c6cbd13cb4a6e68a1,2022-03-26 12:27:30+01:00,Normal,36677,36677,456857,456881,1571,869.0,-24,4392,0,100
010a9d8a4f45252b908337988690c3fad138e334,eb07b5be0ce7c51938ed9b00bae04ebe9a75110c,2022-03-29 07:46:08+02:00,Normal,36687,36687,456905,456905,1574,870.0,0,4392,0,100
d407340e7f8463ee885aaa37789d8aef657b73f5,010a9d8a4f45252b908337988690c3fad138e334,2022-03-29 09:18:22+02:00,Normal,36687,36687,456905,456905,1574,871.0,0,4392,0,100
83c803f161044fbfbfcd9a0c94ca93dc131be662,d407340e7f8463ee885aaa37789d8aef657b73f5,2022-03-29 09:41:57+02:00,Normal,36687,36687,456905,456905,1574,872.0,0,4392,0,100
fac662f4798f7e4e0ed9be6b4fb4a87a80810a68,59ab3fd0e9e606d7f0f7ca26609c06ee679ece97,2022-03-30 07:31:56+02:00,Normal,36718,36713,457127,457070,1575,873.0,57,4449,5,105
0db0a25d8421ff7fda7ef2c5999b263261b04d93,c8459708a7e0a2474255b77d0f104a7f16e8b32c,2022-03-31 08:50:25+02:00,Normal,36718,36718,457635,457635,1576,874.0,0,4449,0,105
0a3c6fe6b2c43b0bb90cb9df3840dcb70edc22a1,0db0a25d8421ff7fda7ef2c5999b263261b04d93,2022-03-31 10:54:59+02:00,Normal,36718,36718,457616,457635,1576,875.0,-19,4430,0,105
d7eb500338e11999962e618f0701e62af511d8e9,0a3c6fe6b2c43b0bb90cb9df3840dcb70edc22a1,2022-03-31 10:54:59+02:00,Normal,36718,36718,457609,457616,1576,876.0,-7,4423,0,105
78277faafd38d8360efc1fd0c9c52d7bb5eec002,2d5215c675c2f128f7e9fc296cd5a0a5a527dff4,2022-04-04 10:31:57+02:00,Normal,36724,36724,457870,457870,1580,877.0,0,4423,0,105
1a7d75cf77639e450854d9bcf9518664f755eb04,78277faafd38d8360efc1fd0c9c52d7bb5eec002,2022-04-05 08:37:28+02:00,Normal,36684,36724,457607,457870,1581,878.0,-263,4160,-40,65
bfe9665502c77baf14ce6cf52af974033bd43164,65effbdb101714ac98b3f143eaccadd8e4f08361,2022-04-06 16:52:13+02:00,Normal,36698,36698,457920,457918,1582,879.0,2,4162,0,65
2ee4caf56b8e000cabbb73ad81ff05738d6d0a35,bfe9665502c77baf14ce6cf52af974033bd43164,2022-04-07 07:02:21+02:00,Normal,36698,36698,457932,457920,1583,880.0,12,4174,0,65
93cae5cb2f9a4ef1514cf1a41f714fef08005200,62739b6e2630e37faa68a86a59fad135cc788cd7,2022-04-11 08:59:33+02:00,Normal,36716,36710,458155,458071,1587,881.0,84,4258,6,71
6723a26e59b0b5429a0c5873941e01a2e1bdbb81,93cae5cb2f9a4ef1514cf1a41f714fef08005200,2022-04-11 08:59:58+02:00,Normal,36716,36716,458208,458155,1587,882.0,53,4311,0,71
78eeff8d33ead67cfc8603477c95e70f8fbe096a,6723a26e59b0b5429a0c5873941e01a2e1bdbb81,2022-04-11 10:32:22+02:00,Normal,36716,36716,458208,458208,1587,883.0,0,4311,0,71
b54fd0e36eaf8d9dd398a84a6748d60f25793788,78eeff8d33ead67cfc8603477c95e70f8fbe096a,2022-04-11 10:45:57+02:00,Normal,36716,36716,458208,458208,1587,884.0,0,4311,0,71
b8759093d8eaea32c8d177615df7de559b6571c7,b54fd0e36eaf8d9dd398a84a6748d60f25793788,2022-04-11 12:58:01+02:00,Normal,36716,36716,458203,458208,1587,885.0,-5,4306,0,71
24f442b91dd1e3e440ec929f4ad9907d53aa69bc,0ad5316f22eabe8fa8b22dc92e61170cfacc3c78,2022-04-12 12:26:51+02:00,Normal,36716,36716,458234,458233,1588,886.0,1,4307,0,71
0b63124c841572f76732feb6e04579295f4628fb,27d52158b274bfd216db532c517da0f7c0ee1733,2022-04-13 10:17:14+02:00,Normal,36726,36716,458248,458241,1589,887.0,7,4314,10,81
a65547c04af52087f78e9bbaa79bdae3807e5c64,0b63124c841572f76732feb6e04579295f4628fb,2022-04-13 11:52:40+02:00,Normal,36726,36726,458274,458248,1589,888.0,26,4340,0,81
fdfb3086fcba1b737ec09676ab4bb95105f3371e,1bdfde085763a0aae0fb07a904ca784e067b6703,2022-04-13 11:56:24+02:00,Normal,36741,36726,458281,458274,1589,889.0,7,4347,15,96
1bdfde085763a0aae0fb07a904ca784e067b6703,a65547c04af52087f78e9bbaa79bdae3807e5c64,2022-04-13 11:56:24+02:00,Normal,36726,36726,458274,458274,1589,890.0,0,4347,0,96
a0bd0063065de054c73d5984d7b4830e29e809e6,db83ac48d4015ce3487405481426c3d2d38335df,2022-04-14 07:53:15+02:00,Normal,36738,36741,458276,458279,1590,891.0,-3,4344,-3,93
1760ad4e8cdbf34a0f38deae300460a0b9c38eac,08f30d1b6ac9b7bc05857f88a70277d5ceb27ba1,2022-04-14 12:12:13+02:00,Normal,36738,36738,458264,458258,1590,892.0,6,4350,0,93
331a460f8f2e4f447b68fba491464b68c9b21fd1,e12670016bbcebcc0d89c2ac4a0121951181fbae,2022-04-18 07:05:52+02:00,Normal,36764,36764,458525,458516,1594,893.0,9,4359,0,93
8e89dfe1c24540d33b577377af633694ff57f505,331a460f8f2e4f447b68fba491464b68c9b21fd1,2022-04-18 07:05:52+02:00,Normal,36772,36764,458545,458525,1594,894.0,20,4379,8,101
f4f2afeb457429f55d6325ed557f8e92a74ee028,903702dfb1461cbb4ab93f841651e6882a72d337,2022-04-19 08:24:24+02:00,Normal,36777,36774,458555,458554,1595,895.0,1,4380,3,104
1ed8ca43f61138b8f8d6f92106c27060753ed4e7,6f311c7e35090957dd93783b71c5d3af7d5329d4,2022-04-21 09:59:09+02:00,Normal,36796,36796,458560,458562,1597,896.0,-2,4378,0,104
eeb0bb63795f7500156abaed2a94aae681a9fc4a,6f453cd2981525b33925faaadc7a6e51fa90df5c,2022-04-22 11:36:27+02:00,Normal,36791,36791,458673,458657,1598,897.0,16,4394,0,104
b34238addceb6b2d40181b625da3b7b7104abfcd,562e3bc09aa094a2ebbd3890fa233d04daafa8c9,2022-04-29 20:16:34+02:00,Normal,36826,36824,459339,459319,1605,898.0,20,4414,2,106
1b3a949ba26ca8fefde7fa224e11c4aadbbdd724,f0ba799edf4f9948da28b5df2000a092ad6a150d,2022-04-29 21:43:55+02:00,Normal,36828,36826,459372,459339,1605,899.0,33,4447,2,108
77926176b281b9c553c934e52acdd1c0377ea601,aca9bb2a12b8985d0cb736d380db97439010cd98,2022-05-02 10:52:33+02:00,Normal,36833,36833,459535,459525,1608,900.0,10,4457,0,108
271a8e73ee382bb487d15e97ffaa675d78869413,77926176b281b9c553c934e52acdd1c0377ea601,2022-05-02 10:52:33+02:00,Normal,36833,36833,459556,459535,1608,901.0,21,4478,0,108
aa8b9279e40da343f5b91e5aec07f868184056f4,3b898ea61ec209ef3ef67e3a6bb55c69bae8c85d,2022-05-03 14:22:34+02:00,Normal,36833,36833,459568,459561,1609,902.0,7,4485,0,108
37470bbd9089b1c64a5783438b42b31336937845,9d04711261156c487c6085171398070ea3df8122,2022-05-04 06:28:51+02:00,Normal,36833,36833,459600,459609,1610,903.0,-9,4476,0,108
27b07a3246bc033cd9ded01238c6dc64731cce35,c5cc750b56e0ed396ca36be39e39505ed6ede4b1,2022-05-05 06:44:34+02:00,Normal,36833,36833,459709,459694,1611,904.0,15,4491,0,108
439cd73c1670a2af25837149a68526fe5555399d,21d8ea4eb3e22d458515b5278c8cd3a15b069799,2022-05-09 10:38:11+02:00,Normal,36835,36835,459985,459980,1615,905.0,5,4496,0,108
441103a04d1d167dc870eaaf90e3fba974f67c93,439cd73c1670a2af25837149a68526fe5555399d,2022-05-10 09:57:28+02:00,Normal,36835,36835,459989,459985,1616,906.0,4,4500,0,108
02dbf1667c6da61ea9346f7c9f174a158b896811,262fde94de5eb6544fc0f289575583436613c045,2022-05-11 09:13:45+02:00,Normal,36939,36944,460727,460703,1617,907.0,24,4524,-5,103
68da6b389c403cb91650754be0e2287696807333,2798c937deb6625a4e6a36e70d4d60ce5faac954,2022-05-12 11:30:03+02:00,Normal,36949,36949,460901,460869,1618,908.0,32,4556,0,103
c112f837d4960b68e912e23139bb97ef01c870a6,19dc3f0f96908898fd62c62517e935331ea29628,2022-05-13 11:23:21+02:00,Normal,36949,36949,461357,461343,1619,909.0,14,4570,0,103
d27e6b233f83c3429f21ff3c250a28ff302637ef,d3677043fce0fec5d082e8cae142d5e5df35a2b5,2022-05-16 06:17:40+02:00,Normal,36949,36949,461385,461368,1622,910.0,17,4587,0,103
647480166bfe7532e8c471fef0146e3a17e6c0c9,76af861356eda3b08bc5e15ad1973f980c7604a3,2022-05-16 09:32:40+02:00,Normal,36949,36949,461399,461399,1622,911.0,0,4587,0,103
4286378a08b059e83f6852c16c155e6146cc1f67,5325a6344ce3d3f64dadfc85256a5d1678f23faa,2022-05-17 14:17:07+02:00,Normal,36973,36973,461734,461734,1623,912.0,0,4587,0,103
2cec020f5bc462954d902bdad1a5955852cecff6,3c6f1fd1f8096b22a52c682a9d295c4396ee3035,2022-05-17 14:59:28+02:00,Normal,36973,36973,461739,461739,1623,913.0,0,4587,0,103
19297de2fe5a9c47e471c64249366f39fe12f16a,2cec020f5bc462954d902bdad1a5955852cecff6,2022-05-18 08:38:08+02:00,Normal,36988,36973,461736,461739,1624,914.0,-3,4584,15,118
981c23c0ccbcaa155a80f894fd9e832beaab661d,9f5548952906c6ea97200c016734b4f519520a64,2022-05-19 09:26:48+02:00,Normal,36988,36988,461651,461748,1625,915.0,-97,4487,0,118
41c4cb253c137edf5a96b7408ea55d57d6e0602a,981c23c0ccbcaa155a80f894fd9e832beaab661d,2022-05-19 10:20:51+02:00,Normal,36990,36988,461702,461651,1625,916.0,51,4538,2,120
f825536b5e09b3a047fec0c10aabd91bace0995c,90dcf271147693a8897f644c4c8943c5b73c02f8,2022-05-21 14:53:37+02:00,Normal,37007,37007,461763,461763,1627,917.0,0,4538,0,120
1733c888f4928e91889e4ae5baf6badbd073e08c,f825536b5e09b3a047fec0c10aabd91bace0995c,2022-05-23 06:06:37+02:00,Normal,37007,37007,461763,461763,1629,918.0,0,4538,0,120
90aabd730a2a434c227faf8a927b0e2ccd67e291,241fe59b74bb6031fa644f3ad55e6ad6a9187510,2022-05-24 10:02:53+02:00,Normal,37007,37007,461780,461780,1630,919.0,0,4538,0,120
ac90529cc58507d9a07610809a795ec5fc3cbf8c,1058fc7023d04d07c22a5e667b6a446705119b14,2022-05-31 11:17:01+02:00,Normal,37015,37015,462023,462022,1637,920.0,1,4539,0,120
ebf25555bbed3e9112d4b726575d60b242daf48a,ac90529cc58507d9a07610809a795ec5fc3cbf8c,2022-05-31 15:21:17+02:00,Normal,37015,37015,462023,462023,1637,921.0,0,4539,0,120
0982cf2a013be291356758a5577ecb3c9f047ba0,93cedc82f29076c824d476354527af1150888e4f,2022-06-01 10:44:34+02:00,Normal,37021,37021,462104,462100,1638,922.0,4,4543,0,120
565ad5ace46aa1e2368450701cba45dd1a95a026,f3e2bb0833105f43efc0cc6f19c8465bc1b1a785,2022-06-01 12:13:15+02:00,Normal,37021,37021,462111,462111,1638,923.0,0,4543,0,120
aaf00450d21cf2a64bb3351070f2b9080858ac9b,00639dbd6d023aaba20efa5497988cd730923633,2022-06-03 21:28:46+02:00,Normal,37033,37033,462204,462210,1640,924.0,-6,4537,0,120
759ff4862a815d55c59bd8147bb180e08431e9c4,860643e12e043d7b0b0c10ebe29d6ada017d95d7,2022-06-16 09:44:19+02:00,Normal,37069,37069,462870,462868,1653,925.0,2,4539,0,120
a0608c4b111555023c24ab7333a42ec53dca6b42,2887b9f67cadc5295ef6a0574de2c2c8fdd66905,2022-06-21 09:09:41+02:00,Normal,37122,37122,463241,463241,1658,926.0,0,4539,0,120
083bfca6b6c00d0f45837a65c2db721eaf46bc07,c627226d05dd52aef59447dcfb29cec2c2b11b8a,2022-06-23 20:22:59+02:00,Normal,37130,37124,463283,463270,1660,927.0,13,4552,6,126
9a22d1769b042a88741f0ff3087f10d94f325d86,083bfca6b6c00d0f45837a65c2db721eaf46bc07,2022-06-24 07:38:13+02:00,Normal,37130,37130,463283,463283,1661,928.0,0,4552,0,126
44ffd8d06fabc07d8333f31439e8dd39ea87329b,6f63e0ce8e36fbdb2d0c4dfd77ed3cf02e467f49,2022-06-27 06:21:31+02:00,Normal,37132,37130,463334,463283,1664,929.0,51,4603,2,128
c48b34e26d0fd2f445d54d191bfe32d58dfb8e7b,20b6e308585d9690de387cd5a2c2e95c6d28ae53,2022-06-27 06:21:31+02:00,Normal,37132,37132,463327,463330,1664,930.0,-3,4600,0,128
20b6e308585d9690de387cd5a2c2e95c6d28ae53,44ffd8d06fabc07d8333f31439e8dd39ea87329b,2022-06-27 06:21:31+02:00,Normal,37132,37132,463330,463334,1664,931.0,-4,4596,0,128
b2eff16806057095c7dd3daa9402ad615e51627f,c48b34e26d0fd2f445d54d191bfe32d58dfb8e7b,2022-06-27 07:13:26+02:00,Normal,37132,37132,463327,463327,1664,932.0,0,4596,0,128
9cf2564d38751a46a71fd322cc08bda717f452a4,d6e0c7c30c1eb83f49345181dc63723968f297ae,2022-06-28 08:53:05+02:00,Normal,37132,37132,463347,463347,1665,933.0,0,4596,0,128
bff5c114be2b7a3fbc735c232abcc6ad4db89a9d,9cf2564d38751a46a71fd322cc08bda717f452a4,2022-06-28 09:27:03+02:00,Normal,37132,37132,463340,463347,1665,934.0,-7,4589,0,128
154dd1c0edb25f3ab1e951eef8e0c2a1e6274e87,72e41a0df6db23410135364223eeda83ac2a8b27,2022-06-28 21:45:03+02:00,Normal,37132,37132,463310,463310,1665,935.0,0,4589,0,128
863aa7541d30247e7eb7a973ff68a7d36f16dc02,03eec9ff6cc78e7c1bcf88bb76ecd11f0d433c72,2022-07-01 19:05:27+02:00,Normal,37132,37132,463328,463326,1668,936.0,2,4591,0,128
54eb8a374d5d98594b264e8ec22337819b37443c,425718726b7d2edd7b8a043f8976e437262b5098,2022-07-04 08:13:41+02:00,Normal,37132,37132,463376,463335,1671,937.0,41,4632,0,128
c6932ea2ea7ec431245b9a343c72318bb758072f,54eb8a374d5d98594b264e8ec22337819b37443c,2022-07-04 10:06:07+02:00,Normal,37132,37132,463376,463376,1671,938.0,0,4632,0,128
d12d7c4c42814736c24731a6a300a79526fc2ef6,c6932ea2ea7ec431245b9a343c72318bb758072f,2022-07-04 10:27:14+02:00,Normal,37132,37132,463376,463376,1671,939.0,0,4632,0,128
249ecc437f79c08b087d0daa0ec8b41f9b25a238,d12d7c4c42814736c24731a6a300a79526fc2ef6,2022-07-05 05:53:49+02:00,Normal,37132,37132,463394,463376,1672,940.0,18,4650,0,128
73766c118781a7f7052bf0a5fbee38b944964e31,18c5ba07cc81be993941ecc2ecc17923b401b66f,2022-07-05 19:05:03+02:00,Normal,37138,37138,463426,463426,1672,941.0,0,4650,0,128
eb3699ea775548a22e0407ad12bf8cbdeaf95ff5,ccbf714ebeff51d1370789e5e487a978d0e2dbfb,2022-07-08 13:30:12+02:00,Normal,37198,37198,463673,463760,1675,942.0,-87,4563,0,128
5e2f4ddf2940704a26a4ac782b851989668d74db,eb3699ea775548a22e0407ad12bf8cbdeaf95ff5,2022-07-09 13:02:07+02:00,Normal,37198,37198,463673,463673,1676,943.0,0,4563,0,128
e59d1ff5627cf9cc551e160d65858a37693de4ed,3e3e8141662c70d74d3aaef9d4b053c9636ea0d7,2022-07-18 20:03:26+02:00,Normal,37205,37205,463838,463838,1685,944.0,0,4563,0,128
24effbceb871e71d3bc320b91252f743714722df,e59d1ff5627cf9cc551e160d65858a37693de4ed,2022-07-19 09:45:11+02:00,Normal,37205,37205,463838,463838,1686,945.0,0,4563,0,128
0e76abb8c445647359a7c5c636a8df5e4cf7bdf9,eae973df6671568a79f3e55b0c971078236100d4,2022-07-21 07:03:32+02:00,Normal,37205,37205,463854,463842,1688,946.0,12,4575,0,128
f81032572107846922745b68d5b7191058fdd5f5,0e76abb8c445647359a7c5c636a8df5e4cf7bdf9,2022-07-21 07:05:50+02:00,Normal,37205,37205,463861,463854,1688,947.0,7,4582,0,128
c773d5794eb425c4836c726bdf6e1e742c94e9c0,7bdb682215de3bf7f8f38f8161b175c225ee25fa,2022-07-26 11:41:19+02:00,Normal,37200,37205,463855,463935,1693,948.0,-80,4502,-5,123
a1e9e9abc592b8f44fa798c6e4e225b1a04f757c,c773d5794eb425c4836c726bdf6e1e742c94e9c0,2022-07-26 11:41:19+02:00,Normal,37162,37200,463707,463855,1693,949.0,-148,4354,-38,85
66f30dbf253f89a3803aebbcee2675ce3e186b00,a1e9e9abc592b8f44fa798c6e4e225b1a04f757c,2022-07-26 11:41:19+02:00,Normal,37162,37162,463695,463707,1693,950.0,-12,4342,0,85
7e3c9c3205e9646261cea5e5a7af7ec0e806690a,66f30dbf253f89a3803aebbcee2675ce3e186b00,2022-07-26 11:42:54+02:00,Normal,37162,37162,463695,463695,1693,951.0,0,4342,0,85
e20e5d1557785ba71e8ef0ceb8ccb85bdc13840a,7e3c9c3205e9646261cea5e5a7af7ec0e806690a,2022-07-26 20:21:27+02:00,Normal,37162,37162,463695,463695,1693,952.0,0,4342,0,85
88dba2e3fd64b64bcf4fae83b256b4f6f492558f,9dff316be41847c505ebf397e4a52a0a71e0acc4,2022-07-27 21:36:25+02:00,Normal,37164,37164,463732,463729,1694,953.0,3,4345,0,85
c18861804feb6a97afbeabb51be748dd60a04458,1e5bbbb2a866faf56e00eb744ab940e40e87d497,2022-07-31 08:16:19+02:00,Normal,37172,37172,463916,463892,1698,954.0,24,4369,0,85
d38324edc840049d42c3454b9487ac370aab5ee9,c18861804feb6a97afbeabb51be748dd60a04458,2022-07-31 09:24:39+02:00,Normal,37172,37172,463916,463916,1698,955.0,0,4369,0,85
ab1955a05e369337c3eaad1a2d34de346932179d,89e695a69b16b8c0e720169b3ca4852cfd0c485f,2022-08-02 11:44:26+02:00,Normal,37179,37174,464017,463931,1700,956.0,86,4455,5,90
919e65b21e96db61ffae0fea6f6e18541bdfad18,bc7aa2a5e91cf65fc7510edaf1776528c7ad07b4,2022-08-03 08:04:34+02:00,Normal,37179,37179,464183,464187,1701,957.0,-4,4451,0,90
cb791a2540c289390b68a3ea9c6a79476890bab2,09e837c5d93d8ac22697e711901a63ead59c9fd4,2022-08-03 11:42:51+02:00,Normal,37181,37181,464374,464220,1701,958.0,154,4605,0,90
d4db417c8e6935222d198925dd4c5ac1ca737909,0638b4e23dbabdcf7d7a6f2a2d5b95b980dece78,2022-08-04 09:16:38+02:00,Normal,37181,37181,464376,464378,1702,959.0,-2,4603,0,90
7e5c8fc51fa891234daf01b7957fdc4e087e2a1e,f476c8847a0bf1a4e20becfb3dc66f4da0dbf579,2022-08-04 15:19:39+02:00,Normal,37181,37181,464384,464384,1702,960.0,0,4603,0,90
5f760025004bdb02f9844011033459c30347f215,7e5c8fc51fa891234daf01b7957fdc4e087e2a1e,2022-08-04 20:00:35+02:00,Normal,37181,37181,464384,464384,1702,961.0,0,4603,0,90
00370342ca3a478660372975b3309ffc4d535be1,0756c61f2ada56e4ae625589099c0141a77737eb,2022-08-06 13:43:16+02:00,Normal,37172,37172,464303,464303,1704,962.0,0,4603,0,90
fd93db97c7228b16a4f92f97ef05b0d72418d952,00370342ca3a478660372975b3309ffc4d535be1,2022-08-06 17:59:31+02:00,Normal,37172,37172,464319,464303,1704,963.0,16,4619,0,90
63884829acd207404f2a5c3cc1d6b4cd0a822b70,c614e811f80ae5ce4e8f1461f54f0600707cf0e6,2022-08-09 06:08:48+02:00,Normal,37174,37166,464396,464378,1707,964.0,18,4637,8,98
f3a06b06b59b3d24d5c2c14a34a8051879203c45,036bb2b74afb50a71e7a945e8dd83499b603ac3a,2022-08-09 09:26:12+02:00,Normal,37180,37180,464406,464411,1707,965.0,-5,4632,0,98
721706f4c40f4970f57647368d45f49e20028628,9e7cb27a5b7363239d1db02d29fe12efdf25b899,2022-08-10 12:28:39+02:00,Normal,37180,37180,464459,464454,1708,966.0,5,4637,0,98
fc0942ada47c6ed9bbd25f8a1d721ae0e2859776,8403da3696730f8b9e7d2ad20c920fcd7c52b62c,2022-08-11 09:53:10+02:00,Normal,37180,37180,464462,464462,1709,967.0,0,4637,0,98
8533a6af8d937d487dd4a9f5c40ac98e111915a8,fc0942ada47c6ed9bbd25f8a1d721ae0e2859776,2022-08-11 09:53:10+02:00,Normal,37180,37180,464461,464462,1709,968.0,-1,4636,0,98
5c803bc0702511c8bc05e9db600367a465514f82,4fcba800b84fc5fb53cdc70e4bea37ec958516fd,2022-08-12 17:30:23+02:00,Normal,37199,37193,464514,464487,1710,969.0,27,4663,6,104
e9fd2b572410b1236da0d3d0933014138d89f44e,bd3602310073edde7220a61ca85dbf128e8ee6ac,2022-08-18 21:02:29+02:00,Normal,37229,37229,465142,465118,1716,970.0,24,4687,0,104
081871bc20cc8b28481109b8dcadc321e177e6be,166a3b32632c141541d1c3f0eff18e1d8b389404,2022-08-26 21:42:44+02:00,Normal,37260,37260,465275,465275,1724,971.0,0,4687,0,104
f210de760b06cd57ff37b416e2bf9eafb0bfe929,b92ffebb0cdc469baaf1b8f0e72dddb069eb2fb4,2022-08-29 09:14:56+02:00,Normal,37254,37254,465323,465323,1727,972.0,0,4687,0,104
4483a9b12f295908e68b82d6599f460de943444f,f210de760b06cd57ff37b416e2bf9eafb0bfe929,2022-08-29 09:55:45+02:00,Normal,37254,37254,465323,465323,1727,973.0,0,4687,0,104
a9e7beb959bc726eab1c192d2625d6ff6cfa70f4,4483a9b12f295908e68b82d6599f460de943444f,2022-08-29 10:07:53+02:00,Normal,37254,37254,465323,465323,1727,974.0,0,4687,0,104
cb06f5ef8c80fc6a610db0fc36fb9dc7c625335a,838cc0f449f96c157cb44eb91984a2753edc7f42,2022-08-31 22:12:30+02:00,Normal,37204,37204,465400,465400,1730,975.0,0,4687,0,104
b9705a70f5a2d113673800eeb4a083c2d51d71cd,cb06f5ef8c80fc6a610db0fc36fb9dc7c625335a,2022-09-01 09:39:12+02:00,Normal,37204,37204,465400,465400,1730,976.0,0,4687,0,104
974942a75039ba43e618f6a5ff95e08b5d5176fd,e64919ae54933ef4840f0e27e51d9fcfd55ecf4b,2022-09-01 21:09:16+02:00,Normal,37204,37204,465414,465446,1730,977.0,-32,4655,0,104
753602d0c65de4767310bfe4957e489eb94c6517,cd1afd553f9c175ebccfc0f50e72b43b9604bd97,2022-09-04 14:32:24+02:00,Normal,37204,37204,465505,465505,1733,978.0,0,4655,0,104
aed92f686d362b731c74a7840085d2e6714e5ef5,753602d0c65de4767310bfe4957e489eb94c6517,2022-09-05 05:21:23+02:00,Normal,37204,37204,465505,465505,1734,979.0,0,4655,0,104
604fadde11966c5fdfe5a236a7a3963ee868f764,aed92f686d362b731c74a7840085d2e6714e5ef5,2022-09-05 06:02:40+02:00,Normal,37204,37204,465505,465505,1734,980.0,0,4655,0,104
69fa2e8eb25d9bdd395fa8857177d4637aaf4c55,19e0587ee596debf77540d6a08ccb6507e60b6a7,2022-09-06 05:54:35+02:00,Normal,37204,37204,465572,465544,1735,981.0,28,4683,0,104
a2e580acf62a3de4f9108cc1af061a02b94b1064,42cd8c390d5f165fd7f6bbdffafd2aa4c2d9a32a,2022-09-07 12:02:08+02:00,Normal,37231,37231,465953,465941,1736,982.0,12,4695,0,104
8c8d100c29fb0a7d70c5d8c0be6cfdf77e0a3d02,8e93fc561e4ead282abe2a12bd6ac393c9d308be,2022-09-15 12:18:44+02:00,Normal,37245,37245,466187,466187,1744,983.0,0,4695,0,104
229360d7adaabb685fd02b92f4f74ff568b6a50d,10178197d57476f69688d4535e550a1ea3a5eac5,2022-09-16 11:14:27+02:00,Normal,37251,37251,466242,466242,1745,984.0,0,4695,0,104
bc33b047848759e7ae90bf85c94ff6cc5913e1ee,229360d7adaabb685fd02b92f4f74ff568b6a50d,2022-09-16 15:12:14+02:00,Normal,37251,37251,466242,466242,1745,985.0,0,4695,0,104
9c42933711667034c9335f408e1a8a53031e9865,6619baab9b02e9f98598993e14cfc2b462b3a710,2022-09-16 21:44:14+02:00,Normal,37251,37251,466242,466242,1745,986.0,0,4695,0,104
2d07f24f15e70bbf4bd68e037ef22d39c22a142d,f88fc72da4eb76f2d464edb4874ef6046f8a8658,2022-09-19 05:15:06+02:00,Normal,37251,37251,466257,466257,1748,987.0,0,4695,0,104
ce6230aa976e8d963226a3956b45a8919215dbd8,cfe3008123ed7c9e3f3a4d51d4a22f9d96634e33,2022-09-22 00:17:04+02:00,Normal,37249,37251,466283,466257,1751,988.0,26,4721,-2,102
37a13cc92d51d5a57b42240b9a5dd250648efa24,ce6230aa976e8d963226a3956b45a8919215dbd8,2022-09-22 12:55:47+02:00,Normal,37249,37249,466297,466283,1751,989.0,14,4735,0,102
f4e592e3837f0625bf5327cc8ce8444279b4deb3,3fb9c74d134ffe9a14ac3349e7652cd8b022db15,2022-09-26 13:36:47+02:00,Normal,37237,37237,466403,466407,1755,990.0,-4,4731,0,102
5d36a8266c7d5d1994d7a7eeb4016f80d9cb0401,1a7b6909ac030d2c4dae2664b08ee0bce9c4c915,2022-09-28 09:26:10+02:00,Normal,37245,37245,466490,466490,1757,991.0,0,4731,0,102
6e891a17220ed19ee41a18c80a5bb76cfd4e926a,80d38de52bb2721a7b44fce4057bcff571afc23a,2022-09-28 11:27:11+02:00,Normal,37243,37245,466473,466494,1757,992.0,-21,4710,-2,100
19e6efa50b603af325e7f62058364f278596758f,468d06109778e3656229ac28c9019ea7246f9b79,2022-09-29 13:20:14+02:00,Normal,37243,37243,466572,466514,1758,993.0,58,4768,0,100
5e0aa362d91d000984995ce374c2d7547d8d107f,6cc0f22a73970dd7c0d29d4d8d2ff9e1cc862b30,2022-09-30 18:18:33+02:00,Normal,37232,37238,466517,466651,1759,994.0,-134,4634,-6,94
bc3b8f152452ba0e41f28baa93c0bf8f39cddb09,5e0aa362d91d000984995ce374c2d7547d8d107f,2022-10-01 07:53:32+02:00,Normal,37241,37232,466544,466517,1760,995.0,27,4661,9,103
f71b0cf769d9ac582ee3d1a8c33d73dad3a770da,3b4a5b9f97f113ca5151cff744019e39a1ed7475,2022-10-03 10:52:21+02:00,Normal,37241,37241,466550,466550,1762,996.0,0,4661,0,103
c583418e3ec2a7f2997f739a51ae07291c18070e,9fbb5b5e16b44dff97a3caa0e288803a80fabdd3,2022-10-04 11:51:18+02:00,Normal,37247,37247,466626,466626,1763,997.0,0,4661,0,103
abc5ca6ab4717d690255583ac18a05d742746f93,7a39a691e1e3fe13588c8885a222eaa6a4648d01,2022-10-07 08:18:04+02:00,Normal,37266,37266,466754,466754,1766,998.0,0,4661,0,103
749cd83e1356740f940613f12b609f078097f252,abc5ca6ab4717d690255583ac18a05d742746f93,2022-10-07 08:26:41+02:00,Normal,37266,37266,466754,466754,1766,999.0,0,4661,0,103
d795259ea96004df0a2469246229a146307bcd2c,564b317fb53e9925b86ca5ef5d3bbcf99387602c,2022-10-07 13:05:35+02:00,Normal,37265,37288,466713,466772,1766,1000.0,-59,4602,-23,80
15682cb0034242fcdfe333cf399d62ab70c3a978,84206607d6bfd61e7f7a88b51163ffd4153e3b5a,2022-10-10 11:17:02+02:00,Normal,37287,37287,466744,466743,1769,1001.0,1,4603,0,80
da8fa764134980ee1079f790cda6616f32cf9c44,6402b064a9a9c7ed9afc87800a7011b449e29dd0,2022-10-10 13:43:10+02:00,Normal,37287,37287,466708,466708,1769,1002.0,0,4603,0,80
004f985b918d5ea36fbed9b050459dd22edaf396,c4aac2ac1e469f0dc27b4dce230c7b29add617ba,2022-10-12 11:50:13+02:00,Normal,37269,37269,466705,466705,1771,1003.0,0,4603,0,80
7c884afe5acc00d1df83390848227f42918ec0d4,da2621c3dfef934000c479750e0276d992025542,2022-10-13 19:49:57+02:00,Normal,37285,37285,466723,466723,1772,1004.0,0,4603,0,80
577dbcbb4f46df02e1f85179798a1079733c5a97,3283120cca5d5eba5c3619612d0de5ad49dcf054,2022-10-24 09:11:48+02:00,Normal,37285,37285,466756,466756,1783,1005.0,0,4603,0,80
6d41f5e5edc54fec9f71540fbddb1197a862b9cc,c0fc1b5302f5d9d82e2255fb5758321fbac34949,2022-10-25 20:01:25+02:00,Normal,37293,37293,466861,466854,1784,1006.0,7,4610,0,80
02940ebce1acfc8b43b40abfc718209101ad92b2,6d41f5e5edc54fec9f71540fbddb1197a862b9cc,2022-10-26 08:18:47+02:00,Normal,37293,37293,466861,466861,1785,1007.0,0,4610,0,80
80777d30b34968c39479d943822d2d335aba1571,02940ebce1acfc8b43b40abfc718209101ad92b2,2022-10-26 09:42:51+02:00,Normal,37293,37293,466862,466861,1785,1008.0,1,4611,0,80
2e82fa54ca732948f3ad3f723acb341f60e45f19,80777d30b34968c39479d943822d2d335aba1571,2022-10-26 09:42:51+02:00,Normal,37293,37293,466862,466862,1785,1009.0,0,4611,0,80
e51c998f8d6fbc9421e4a1226c144d8035c126e0,2e82fa54ca732948f3ad3f723acb341f60e45f19,2022-10-26 10:25:07+02:00,Normal,37293,37293,466862,466862,1785,1010.0,0,4611,0,80
eb6cc01d0f62c73441a3610193ba210176d0935f,350455b666a289d336fca770578887ce51f1aebe,2022-10-26 20:10:33+02:00,Normal,37294,37294,466909,466909,1785,1011.0,0,4611,0,80
d559cb02da30f74debbb1fc3a46de0df134d2d80,eb6cc01d0f62c73441a3610193ba210176d0935f,2022-10-27 08:41:03+02:00,Normal,37294,37294,466918,466909,1786,1012.0,9,4620,0,80
635e5643b3921e278dbddf8f13ecb66f17cd6aee,f47fec31f8b51ad8fdc0a5d6805d0130f8700ca8,2022-11-01 06:54:19+01:00,Normal,37301,37301,467080,467080,1791,1013.0,0,4620,0,80
c765b62e3258de4dce9935ab7aed430346dfbc10,635e5643b3921e278dbddf8f13ecb66f17cd6aee,2022-11-01 07:27:30+01:00,Normal,37301,37301,467080,467080,1791,1014.0,0,4620,0,80
57c2e5da710b583110d8c7c20e91774a61d7472f,d5bcdf858d962d02de925603c17986980f03729a,2022-11-02 12:30:16+01:00,Normal,37303,37301,467152,467131,1792,1015.0,21,4641,2,82
7b0e9ea53ca99de2f485ec582f3a79be34b531d4,0f4964535cb81c12303dd103c4bdba4891c99c2c,2022-11-04 09:30:23+01:00,Normal,37303,37303,467202,467182,1794,1016.0,20,4661,0,82
d6fbfea08d9bae4165df6a0cfbd4520b5e2242b2,59bea9efd2768102fc9d3aedda469502c218e9b7,2022-11-09 14:04:14+01:00,Normal,37337,37337,467763,467763,1799,1017.0,0,4661,0,82
67504ea505797f515fb51c9688ce746c0997e9b2,5c23d9f0c32f166c81ecb6f3f01d5077a6084318,2022-11-16 08:16:40+01:00,Normal,37418,37418,468084,468084,1806,1018.0,0,4661,0,82
2848e5d0ce5cf3c31fe87525536093b21d570f69,67504ea505797f515fb51c9688ce746c0997e9b2,2022-11-16 11:30:59+01:00,Normal,37418,37418,468085,468084,1806,1019.0,1,4662,0,82
c0a93d39411004300dfda2deb3dc093b69ac6368,25904db9154c5be3ecda9585d96f536841af9126,2022-11-18 14:47:29+01:00,Normal,37423,37423,468212,468228,1808,1020.0,-16,4646,0,82
744a1af7f943106e30d538e6ace55c2c66ccd791,96a598356a9ea8c2c05b22cadc12e256a3b295fd,2022-11-22 11:59:48+01:00,Normal,37469,37469,468316,468316,1812,1021.0,0,4646,0,82
7d5329852f19c6ae78c6f6f3d3e41835377bf295,744a1af7f943106e30d538e6ace55c2c66ccd791,2022-11-22 14:26:23+01:00,Normal,37472,37469,468351,468316,1812,1022.0,35,4681,3,85
a411b909671b7b8f8773af6b7cffa6992fe29138,4035bab56f2862a25cd7bfba41a84e58672cb1cc,2022-11-23 09:35:48+01:00,Normal,37473,37473,468393,468387,1813,1023.0,6,4687,0,85
662497cece5480b39d1d0c7f68c7b0ca395be923,64b3c413da011f55469165256261f406a277e822,2022-11-28 08:13:51+01:00,Normal,37445,37445,468482,468482,1818,1024.0,0,4687,0,85
20d575b101608c1475bc2881f83b04da0e68ef7d,662497cece5480b39d1d0c7f68c7b0ca395be923,2022-11-28 09:30:22+01:00,Normal,37445,37445,468487,468482,1818,1025.0,5,4692,0,85
60a7bd89860e504c0c33b02c78edcac87f6d1b5a,20d575b101608c1475bc2881f83b04da0e68ef7d,2022-11-28 09:47:52+01:00,Normal,37445,37445,468488,468487,1818,1026.0,1,4693,0,85
e8dcef155c1848ef49e54f787a7d20faf3bf9296,0db8bf3d60f7a027391ce89555bdb4a95ad0a227,2022-11-30 08:22:10+01:00,Normal,37453,37453,468607,468607,1820,1027.0,0,4693,0,85
3d3e955efaaeb4cc968e522592c5c1e47bdc72c4,48531f53ae9c5781094c91b6aaec204920359018,2022-12-05 12:08:21+01:00,Normal,37473,37473,468765,468766,1825,1028.0,-1,4692,0,85
514884e9a555c51afba3d26d9370a908af4752a6,cbce427c17b66faec7ced0639346dc6905a498f9,2022-12-06 05:59:43+01:00,Normal,37468,37468,468803,468803,1826,1029.0,0,4692,0,85
29b6a177d81b9a8d833529bebfc67ef48bda3c7f,845a5db38fd3d2695af8cece78951729936a0196,2022-12-06 11:14:32+01:00,Normal,37468,37468,468822,468822,1826,1030.0,0,4692,0,85
95a101a690402076321331d56e67d896e8f6dfbc,0036bcdcb65874f63fff8139fe86574fa155eb26,2022-12-08 05:53:18+01:00,Normal,37504,37515,468870,468924,1828,1031.0,-54,4638,-11,74
cbc0fb370583c6371eb2901f752ce286f008a6a4,95a101a690402076321331d56e67d896e8f6dfbc,2022-12-08 09:00:35+01:00,Normal,37504,37504,468873,468870,1828,1032.0,3,4641,0,74
9da2210f121085e998dc7cedb783bc4568390b92,cbc0fb370583c6371eb2901f752ce286f008a6a4,2022-12-08 14:31:35+01:00,Normal,37504,37504,468875,468873,1828,1033.0,2,4643,0,74
3fec3bf90bef36b26efe5e47a92bf5a8041a207b,9da2210f121085e998dc7cedb783bc4568390b92,2022-12-09 10:20:47+01:00,Normal,37504,37504,468875,468875,1829,1034.0,0,4643,0,74
9d9ec0c79f52efad3a4d3f6ac4644d5c9fb1d22c,32268456d6494483f9a737dc7c32bbbf1eceab8c,2022-12-14 11:18:18+01:00,Normal,37504,37504,468981,468981,1834,1035.0,0,4643,0,74
1e4da439556cdd69eb9f91e07f99cf77997e70d2,05d70fb92b72f9701bea99c809a5edd53b290de9,2022-12-16 12:24:49+01:00,Normal,37543,37543,469405,469394,1836,1036.0,11,4654,0,74
0c60d11bdbe5bf353e3fa0f2db1cb85786ca3448,289e9a75afb52918a3efbdaf5e72f45a54089083,2022-12-19 20:25:38+01:00,Normal,37555,37555,469584,469584,1839,1037.0,0,4654,0,74
2d676ee119696250a8b76c69ec9d9b799ddeb6b4,32d70b2f55b1f74736fd11bc8efce890ad5fa2f0,2022-12-20 19:34:59+01:00,Normal,37555,37555,469579,469579,1840,1038.0,0,4654,0,74
3b24a3fa337bedc11352a17952cb9c3f77f9b9f2,2d676ee119696250a8b76c69ec9d9b799ddeb6b4,2022-12-21 11:41:29+01:00,Normal,37555,37555,469577,469579,1841,1039.0,-2,4652,0,74
ae0899be0d787fbfc5f5ab2b18c5a8219d822d2b,3b24a3fa337bedc11352a17952cb9c3f77f9b9f2,2022-12-22 07:12:17+01:00,Normal,37569,37555,469607,469577,1842,1040.0,30,4682,14,88
e07e83589b05e030d1bc0015a758bf3abc4da7cc,5aaad5f39c67591ba3d60c57ffa03fac12965f26,2022-12-24 21:04:59+01:00,Normal,37578,37578,469797,469793,1844,1041.0,4,4686,0,88
48b6108e50abb1b1f8143721bad8bd7e0be4cc89,e07e83589b05e030d1bc0015a758bf3abc4da7cc,2022-12-24 21:16:22+01:00,Normal,37578,37578,469794,469797,1845,1042.0,-3,4683,0,88
279967ec859a9a5240318cf29a077539b0e3139f,7eee1dca420ee7c4451d24cd32fa08aed0dcbb36,2022-12-29 06:07:51+01:00,Normal,37642,37642,470593,470589,1849,1043.0,4,4687,0,88
ecbb5db65dce7193a941b117cdd33839e5536b2e,298d02a77a69321af8c0023df3250663e9d1362d,2022-12-29 11:35:41+01:00,Normal,37642,37642,470629,470627,1849,1044.0,2,4689,0,88
6e9e7ec472bdc870152e1f4f4130ecc07cdfc820,ecbb5db65dce7193a941b117cdd33839e5536b2e,2022-12-30 12:22:30+01:00,Normal,37642,37642,470646,470629,1850,1045.0,17,4706,0,88
174d8157b5700f6451ac0bdc3eef7e73121bc4a4,c179ad9fe7e82dcb80261aa016f2fe18c8fcc181,2023-01-02 08:10:59+01:00,Normal,37642,37642,470654,470654,1853,1046.0,0,4706,0,88
75500feecddcb27b6ab65c9057e7317024cef761,174d8157b5700f6451ac0bdc3eef7e73121bc4a4,2023-01-02 08:50:33+01:00,Normal,37642,37642,470654,470654,1853,1047.0,0,4706,0,88
6774e9359cbdbf7b8c448597c103288ac381519a,afa2e28205fe708334ad463b6d3b0e9960b945a6,2023-01-03 05:46:40+01:00,Normal,37642,37642,470682,470684,1854,1048.0,-2,4704,0,88
5cf9ff970e08b10d3f7d62734dbce9e8eaeff453,8d67e16493c903adc9d049141028bc0fff43f8c8,2023-01-04 11:28:09+01:00,Normal,37651,37651,470851,470851,1855,1049.0,0,4704,0,88
7d9329935a842510fab5eb2634bf08e40e1cb2cb,6c86495bcee22eac19d7fb040b2988b830707cbd,2023-01-05 16:34:14+01:00,Normal,37651,37651,470841,470841,1856,1050.0,0,4704,0,88
63d1cb0092f8933a92f471c5150d61140f33882c,8cf3831822b708270f38fabb630bbdfdfbb41be1,2023-01-05 18:09:33+01:00,Normal,37651,37651,470850,470850,1856,1051.0,0,4704,0,88
552384fa977901dcbc33cc999cd38dddcdc0eef1,72efd840a8cb6ee35a3732d8bb434e7361970b3c,2023-01-10 11:51:09+01:00,Normal,37814,37814,471624,471579,1861,1052.0,45,4749,0,88
d4b4c1cae441230e5622163a42ef491588f2b868,552384fa977901dcbc33cc999cd38dddcdc0eef1,2023-01-10 14:25:44+01:00,Normal,37814,37814,471624,471624,1861,1053.0,0,4749,0,88
829f4d1448f7b40238b47592fc17061bf77b0f23,d4b4c1cae441230e5622163a42ef491588f2b868,2023-01-11 05:36:40+01:00,Normal,37814,37814,471624,471624,1862,1054.0,0,4749,0,88
4593bc5da115f2e808a803a4ec24104b6c7a6152,d16079dd90320141c2024809ba0fce43f0f2cb02,2023-01-11 12:49:12+01:00,Normal,37814,37814,471625,471625,1862,1055.0,0,4749,0,88
d02a9f0cee84e3d23f676bdf2ab6aadbf4a5bfe8,4593bc5da115f2e808a803a4ec24104b6c7a6152,2023-01-12 06:04:10+01:00,Normal,37814,37814,471631,471625,1863,1056.0,6,4755,0,88
648005dee62481acc1784e5c9625e90f0fd6aab4,32940d390a00a30a6409282d314d617667892841,2023-01-12 13:23:47+01:00,Normal,37866,37866,472134,472134,1863,1057.0,0,4755,0,88
c2118d72d61746f2462fca695dbf3adf44ebf8f7,648005dee62481acc1784e5c9625e90f0fd6aab4,2023-01-13 11:30:27+01:00,Normal,37866,37866,472160,472134,1864,1058.0,26,4781,0,88
0e2649fdf40cedc5be7e2c0e5f7711f315e36b84,c8a76059ff6ff37fb51972fe2ba8b9d9464af769,2023-01-17 08:24:08+01:00,Normal,37866,37866,472231,472174,1868,1059.0,57,4838,0,88
c8a76059ff6ff37fb51972fe2ba8b9d9464af769,0fbdb9784da915fce5dcc1fe82bac9b4785749e5,2023-01-17 08:24:08+01:00,Normal,37866,37866,472174,472174,1868,1060.0,0,4838,0,88
9409312eef72d1263dae4b0303523260a54010c5,e734cccea0811863ece6ee2d25b5f58925580d09,2023-01-17 08:51:17+01:00,Normal,37866,37866,472231,472231,1868,1061.0,0,4838,0,88
772cd2b15b158679b9dc15fb599aa935ec7c25b1,0e2649fdf40cedc5be7e2c0e5f7711f315e36b84,2023-01-17 08:51:17+01:00,Normal,37866,37866,472231,472231,1868,1062.0,0,4838,0,88
e734cccea0811863ece6ee2d25b5f58925580d09,772cd2b15b158679b9dc15fb599aa935ec7c25b1,2023-01-17 08:51:17+01:00,Normal,37866,37866,472231,472231,1868,1063.0,0,4838,0,88
004e90033e20144db9dac8e1459d6bbe7690b615,9409312eef72d1263dae4b0303523260a54010c5,2023-01-17 10:11:50+01:00,Normal,37866,37866,472231,472231,1868,1064.0,0,4838,0,88
ea92a4dc2879e084b46d9b141c0a535d536be2e6,d18d6d0d78ee491e738818a9cc21cc124ffb70c3,2023-01-17 11:49:15+01:00,Normal,37866,37866,472231,472231,1868,1065.0,0,4838,0,88
b119f4329c2a4878f1c72f4d25d193d080792f62,23c87874397a22ca80c0d6fa8648fb58ee3ab28a,2023-01-17 11:49:15+01:00,Normal,37665,37665,469311,469390,1868,1066.0,-79,4759,0,88
139135627650ed6aaaf4c755b82c3bd43f2b8f51,b119f4329c2a4878f1c72f4d25d193d080792f62,2023-01-17 11:49:15+01:00,Normal,37665,37665,469289,469311,1868,1067.0,-22,4737,0,88
4d78d7338cc5cfaa0afcfc9d240d753328bbf399,139135627650ed6aaaf4c755b82c3bd43f2b8f51,2023-01-17 11:49:15+01:00,Normal,37665,37665,469261,469289,1868,1068.0,-28,4709,0,88
ba082e09524c9fba9fa8ba472c896ef645b09dd6,4d78d7338cc5cfaa0afcfc9d240d753328bbf399,2023-01-17 11:49:15+01:00,Normal,37658,37665,469210,469261,1868,1069.0,-51,4658,-7,81
9a01311d204ebf23e615a0802cedcc7b6b373826,ba082e09524c9fba9fa8ba472c896ef645b09dd6,2023-01-17 11:49:15+01:00,Normal,37652,37658,469179,469210,1868,1070.0,-31,4627,-6,75
d6816bff73b37af05c968c009419c7c608e37307,9a01311d204ebf23e615a0802cedcc7b6b373826,2023-01-17 11:49:15+01:00,Normal,37652,37652,469133,469179,1868,1071.0,-46,4581,0,75
23c87874397a22ca80c0d6fa8648fb58ee3ab28a,23ec318988cb22bef176b9d81e4091715a4f41ff,2023-01-17 11:49:15+01:00,Normal,37665,37677,469390,469442,1868,1072.0,-52,4529,-12,63
71d1203b07d3092062aa9ebc0ab198abfc144d54,d6816bff73b37af05c968c009419c7c608e37307,2023-01-17 11:49:15+01:00,Normal,37602,37652,468758,469133,1868,1073.0,-375,4154,-50,13
b5ac6e78f838376b61f3f7dfccd66f906ad6d394,ce7b4f39e3635bfcaa2cec84d5da93c1dedcaa9c,2023-01-17 11:49:15+01:00,Normal,37576,37602,468499,468619,1868,1074.0,-120,4034,-26,-13
98756c685ee173bbd43f21ed0553f808be835ce5,b5ac6e78f838376b61f3f7dfccd66f906ad6d394,2023-01-17 11:49:15+01:00,Normal,37584,37576,468420,468499,1868,1075.0,-79,3955,8,-5
94ad46e9d8077d8fadce991af85be657b4a4e2a0,98756c685ee173bbd43f21ed0553f808be835ce5,2023-01-17 11:49:15+01:00,Normal,37584,37584,468402,468420,1868,1076.0,-18,3937,0,-5
003081468e28db5af4d7c983f4d8df4c74c20607,94ad46e9d8077d8fadce991af85be657b4a4e2a0,2023-01-17 11:49:15+01:00,Normal,37599,37584,468358,468402,1868,1077.0,-44,3893,15,10
f39f12030277915f20011f48a0f5eb0d486943b6,003081468e28db5af4d7c983f4d8df4c74c20607,2023-01-17 11:49:15+01:00,Normal,37599,37599,468358,468358,1868,1078.0,0,3893,0,10
4fc711a1085c6f545705a206e96c7be64e73a369,f39f12030277915f20011f48a0f5eb0d486943b6,2023-01-17 11:49:15+01:00,Normal,37599,37599,468358,468358,1868,1079.0,0,3893,0,10
ce7b4f39e3635bfcaa2cec84d5da93c1dedcaa9c,71d1203b07d3092062aa9ebc0ab198abfc144d54,2023-01-17 11:49:15+01:00,Normal,37602,37602,468619,468758,1868,1080.0,-139,3754,0,10
23ec318988cb22bef176b9d81e4091715a4f41ff,5c10041f4636c3dfe637924ab24da85dd657d790,2023-01-17 11:49:15+01:00,Normal,37677,37679,469442,469689,1868,1081.0,-247,3507,-2,8
5c10041f4636c3dfe637924ab24da85dd657d790,e01970e9d23a241473671ea26126f8440db4dead,2023-01-17 11:49:15+01:00,Normal,37679,37679,469689,469725,1868,1082.0,-36,3471,0,8
0be8095b254fad65b2480d677ebe6098c41bbad6,43b01300b7c7e9d24b549a408010e52a09726060,2023-01-17 11:49:15+01:00,Normal,37831,37841,471598,471707,1868,1083.0,-109,3362,-10,-2
490cccbe7e83874923b276eed26cc23b0db5ebb9,ea92a4dc2879e084b46d9b141c0a535d536be2e6,2023-01-17 11:49:15+01:00,Normal,37866,37866,472231,472231,1868,1084.0,0,3362,0,-2
6c0539ed7c7a1ddeaac3ff91622ebf7a8c8442b9,490cccbe7e83874923b276eed26cc23b0db5ebb9,2023-01-17 11:49:15+01:00,Normal,37851,37866,472189,472231,1868,1085.0,-42,3320,-15,-17
ef46f3778a0e8fee7f68c4cfb7ad60a3c8765934,6c0539ed7c7a1ddeaac3ff91622ebf7a8c8442b9,2023-01-17 11:49:15+01:00,Normal,37851,37851,472012,472189,1868,1086.0,-177,3143,0,-17
4aa06890805f8bc619d240ca5b4e2cd81be308c1,ef46f3778a0e8fee7f68c4cfb7ad60a3c8765934,2023-01-17 11:49:15+01:00,Normal,37843,37851,471815,472012,1868,1087.0,-197,2946,-8,-25
602d9a312facc64d44619c61c3863d3d0820006a,4aa06890805f8bc619d240ca5b4e2cd81be308c1,2023-01-17 11:49:15+01:00,Normal,37841,37843,471791,471815,1868,1088.0,-24,2922,-2,-27
4eb97a90f0b4484fb13dd2166a61f9fe7256e9d0,602d9a312facc64d44619c61c3863d3d0820006a,2023-01-17 11:49:15+01:00,Normal,37841,37841,471764,471791,1868,1089.0,-27,2895,0,-27
43b01300b7c7e9d24b549a408010e52a09726060,4eb97a90f0b4484fb13dd2166a61f9fe7256e9d0,2023-01-17 11:49:15+01:00,Normal,37841,37841,471707,471764,1868,1090.0,-57,2838,0,-27
e01970e9d23a241473671ea26126f8440db4dead,daf88e778bd39d908dca9efc3571d37adbd2ff4a,2023-01-17 11:49:15+01:00,Normal,37679,37685,469725,469807,1868,1091.0,-82,2756,-6,-33
8d98f99a4ab5de6f2c730399f53eba8bf6bea470,0be8095b254fad65b2480d677ebe6098c41bbad6,2023-01-17 11:49:15+01:00,Normal,37772,37831,471205,471598,1868,1092.0,-393,2363,-59,-92
e6f82438d4e3750e8d299bfd79dac98eebe9f1e0,8d98f99a4ab5de6f2c730399f53eba8bf6bea470,2023-01-17 11:49:15+01:00,Normal,37706,37772,470752,471205,1868,1093.0,-453,1910,-66,-158
2fad1632571af551d6065d7eced93ffe93a8a945,e6f82438d4e3750e8d299bfd79dac98eebe9f1e0,2023-01-17 11:49:15+01:00,Normal,37706,37706,470713,470752,1868,1094.0,-39,1871,0,-158
4982958ec0c359908566fc1f34ef71297ea4337d,2fad1632571af551d6065d7eced93ffe93a8a945,2023-01-17 11:49:15+01:00,Normal,37706,37706,470166,470713,1868,1095.0,-547,1324,0,-158
182d25eb7a227206746bfa30aab13aaa34d1de84,4982958ec0c359908566fc1f34ef71297ea4337d,2023-01-17 11:49:15+01:00,Normal,37685,37706,469939,470166,1868,1096.0,-227,1097,-21,-179
31878b4d7387835c5cec5e7fc5b473b737065a58,182d25eb7a227206746bfa30aab13aaa34d1de84,2023-01-17 11:49:15+01:00,Normal,37685,37685,469871,469939,1868,1097.0,-68,1029,0,-179
daf88e778bd39d908dca9efc3571d37adbd2ff4a,31878b4d7387835c5cec5e7fc5b473b737065a58,2023-01-17 11:49:15+01:00,Normal,37685,37685,469807,469871,1868,1098.0,-64,965,0,-179
d18d6d0d78ee491e738818a9cc21cc124ffb70c3,004e90033e20144db9dac8e1459d6bbe7690b615,2023-01-17 11:49:15+01:00,Normal,37866,37866,472231,472231,1868,1099.0,0,965,0,-179
a209f6625936cff2c714e99735782663dc95218f,e2964fed1761981ff7e5c60762e954f307cf7969,2023-01-17 14:05:32+01:00,Normal,37599,37599,468358,468358,1868,1100.0,0,965,0,-179
2785e121c7eb941202565343d3880da6ba5aa21d,a209f6625936cff2c714e99735782663dc95218f,2023-01-17 19:24:31+01:00,Normal,37599,37599,468358,468358,1868,1101.0,0,965,0,-179
3bbe22dafcc69c5ffa79707f5a74eb1faf466e12,d54717118360e8679aa2bd0c5a1625f3e84712ba,2023-01-18 09:46:01+01:00,Normal,37571,37599,468087,468358,1869,1102.0,-271,694,-28,-207
b209518089131c6b4afd18b1d9c320ba3521c5ab,3bbe22dafcc69c5ffa79707f5a74eb1faf466e12,2023-01-18 11:08:39+01:00,Normal,37559,37571,468118,468087,1869,1103.0,31,725,-12,-219
a04565845ae3e766a1a4ec827a6e1f4fac335c3a,b209518089131c6b4afd18b1d9c320ba3521c5ab,2023-01-18 12:57:54+01:00,Normal,37559,37559,468118,468118,1869,1104.0,0,725,0,-219
23e886886249ebe8f80a48b0d25fbb5308eeb06f,fd21f82aa82b0d75a161f618ef944ebe0923e0ab,2023-01-18 19:11:18+01:00,Normal,37545,37559,468117,468128,1869,1105.0,-11,714,-14,-233
882f99031e6e447384bfe22044cc980567d2f40d,d8e1442ce2c56282785dd806e5c1147975e8c857,2023-01-25 22:25:29+01:00,Normal,37540,37540,468114,468114,1877,1106.0,0,714,0,-233
2b1242abb3989f5d74e787b09132d01bcbee5b55,882f99031e6e447384bfe22044cc980567d2f40d,2023-01-26 09:31:40+01:00,Normal,37545,37540,468139,468114,1877,1107.0,25,739,5,-228
82dad11bfe45f96f15e2330f58f62919cab9f14c,246eb4836a6fb967880f838aa0d22ecfdca8b6f1,2023-01-27 21:28:10+01:00,Normal,37545,37545,468169,468149,1879,1108.0,20,759,0,-228
4dcb919c9772df28e502f3657bcd6a3826599718,097e3a70c1481ee7b042b2edd91b2be86fb7b5b6,2023-02-01 11:34:49+01:00,Normal,37544,37544,468127,468127,1883,1109.0,0,759,0,-228
36e3eef7d5a4c88671d20a561788679d0d9c334c,4dcb919c9772df28e502f3657bcd6a3826599718,2023-02-01 12:09:03+01:00,Normal,37544,37544,468127,468127,1883,1110.0,0,759,0,-228
f3c89744cc801cc7d134bca9958c4a74aa76380f,36e3eef7d5a4c88671d20a561788679d0d9c334c,2023-02-01 13:18:34+01:00,Normal,37544,37544,468127,468127,1883,1111.0,0,759,0,-228
c626173833784c86920b448793ac45005af4c058,f3c89744cc801cc7d134bca9958c4a74aa76380f,2023-02-02 09:27:15+01:00,Normal,37544,37544,468127,468127,1884,1112.0,0,759,0,-228
5e9aded33f46dd78c5b6050186ba54ff9b02e986,017fa23d3b0aee9142f531c2a0002fc86c82a54c,2023-02-04 13:37:44+01:00,Normal,37553,37553,468194,468194,1886,1113.0,0,759,0,-228
2fd755b361d3da2cd0440fc9839feb2bb69b027b,69069a443a906dd4060a8047e683657d40b4c383,2023-02-08 16:38:55+01:00,Normal,37563,37563,468350,468327,1890,1114.0,23,782,0,-228
b6ed389eec3e72d50301f456d711496331abd7b3,534ac4829764f317cf2fbc4a18354fcc998c1425,2023-02-10 21:08:44+01:00,Normal,37586,37586,468411,468411,1893,1115.0,0,782,0,-228
bae053d497ba8a8de7e4f725973924bfb1885fd2,85366fbca723c9b37d0ac9db1d44e3f1cb188db2,2023-02-16 19:18:55+01:00,Normal,37632,37632,468846,468846,1898,1116.0,0,782,0,-228
5afd8c69404d718d254399fb5804efe0aa24fa8a,6cbc403b8ee7014bd6dae4892d404eedb1d4a50d,2023-02-21 08:42:28+01:00,Normal,37667,37667,469084,469068,1903,1117.0,16,798,0,-228
96bc4254ee84596e0d1fef1f2356d8736da3857a,a91e59e4a0fa9cbc6c662feaad6ac17b0f07ce9a,2023-02-21 12:47:52+01:00,Normal,37667,37667,469117,469098,1903,1118.0,19,817,0,-228
16c966ff7fc9ce01e3afd87ef2af55859cadb587,5b3d3e400ab9334ba429ca360c9818c6dfc3a51b,2023-02-23 21:12:17+01:00,Normal,37675,37675,469435,469416,1906,1119.0,19,836,0,-228
2c428b37ae14b1514cfe1466fd91f01d56799bf4,40e88ae8c899bcae3a9520f7a6519dd178185f85,2023-02-24 09:02:45+01:00,Normal,37669,37675,469445,469438,1906,1120.0,7,843,-6,-234
498bff949925c672bcef17261e59316ef9b0bc6f,ba755ca13123d2691a0926ddb64e5d0a2906a880,2023-02-28 12:56:19+01:00,Normal,37669,37669,469483,469483,1910,1121.0,0,843,0,-234
9cf2a5df70051dffcefe21c6b27203e2d5804922,498bff949925c672bcef17261e59316ef9b0bc6f,2023-03-01 13:02:54+01:00,Normal,37669,37669,469483,469483,1911,1122.0,0,843,0,-234
6015bab80e28aef2669f6fac53423aa65f70cb08,9cf2a5df70051dffcefe21c6b27203e2d5804922,2023-03-01 13:02:57+01:00,Normal,37669,37669,469483,469483,1911,1123.0,0,843,0,-234
5933d7033d6dd13f874e2899d3ffe52ce1f668b9,14459f80ee3a9e005989db37c26fd13bb6d2fab2,2023-03-01 13:33:23+01:00,Normal,37669,37669,469483,469483,1911,1124.0,0,843,0,-234
9953c804a9375956a542da94665662d306dff48d,ef00d6ef8846c6b17d41ce46fa3798313e0c5b66,2023-03-02 06:05:40+01:00,Normal,37674,37669,469509,469483,1912,1125.0,26,869,5,-229
52e54860bf9e7b84e312a8f4edfcdcfc164592cb,17e08b2177928b02158997ee1c44d8322a2e6eb8,2023-03-03 10:08:06+01:00,Normal,37674,37702,469534,469613,1913,1126.0,-79,790,-28,-257
61f599aeb991095baa510225a4adeee91d0d43cc,868e2fcddae6720d5713924a785339d1665f1bb9,2023-03-04 13:09:38+01:00,Normal,37751,37751,470013,470007,1914,1127.0,6,796,0,-257
2660bc19f396b0aa74b11e00452ad39df0dba825,61f599aeb991095baa510225a4adeee91d0d43cc,2023-03-05 13:19:09+01:00,Normal,37751,37751,470017,470013,1915,1128.0,4,800,0,-257
9a07999aef7958c9b5441e368cd90646d0edc5c9,507bc1364816370b1902f06e98818d518a3fe0e2,2023-03-06 17:31:26+01:00,Normal,37751,37751,470016,470016,1916,1129.0,0,800,0,-257
18473004afd82a616ba6c9ac22f476347fde4846,32d4b61c313be5169137047e9fb3668da20a5d89,2023-03-09 08:55:08+01:00,Normal,37780,37780,470365,470365,1919,1130.0,0,800,0,-257
cc67344db9de0248ba1064f7e986c6b29276a7b1,a52bdea5a27ba44b13eda93642231c65c581e083,2023-03-09 13:44:34+01:00,Normal,37780,37780,470372,470372,1919,1131.0,0,800,0,-257
fbe850106b2e4b85f838219cb9e1df95fba6c164,03bc92af978f2148c1141673c730f17772cd7037,2023-03-13 12:06:30+01:00,Normal,37783,37783,470543,470543,1923,1132.0,0,800,0,-257
254ad2e3450d8175170914f06af8358d2becc35b,fbe850106b2e4b85f838219cb9e1df95fba6c164,2023-03-14 05:45:30+01:00,Normal,37783,37783,470547,470543,1924,1133.0,4,804,0,-257
78da5ca0c1f2ab3201f8f6cd629e80d805ea023d,8a844e761d098d4005725f991a5e120a1f17cb70,2023-03-15 13:05:48+01:00,Normal,37783,37783,470561,470561,1925,1134.0,0,804,0,-257
e10c1688f96e3b2d202fe401472b7b25f6105969,2ffa815c734e12262a3cb8ce5664f297128ae47f,2023-03-18 14:05:41+01:00,Normal,37808,37808,470759,470735,1928,1135.0,24,828,0,-257
0eb3e9bd754e4c9fac8b616b705178727fc8031e,e10c1688f96e3b2d202fe401472b7b25f6105969,2023-03-20 06:02:10+01:00,Normal,37808,37808,470759,470759,1930,1136.0,0,828,0,-257
73ae8545ae620469550f1adcfe63fb9b9e4f3eb3,216eb63883050f6a3bf5d306e42972e7a6b6dff5,2023-03-23 10:32:56+01:00,Normal,37853,37853,470895,470894,1933,1137.0,1,829,0,-257
39d1e45227e060746ed461fddde80fa2b6cf0dcd,73ae8545ae620469550f1adcfe63fb9b9e4f3eb3,2023-03-23 10:44:01+01:00,Normal,37853,37853,470896,470895,1933,1138.0,1,830,0,-257
659f6b5bc5d68661a071f0cd13b8dab678067023,cad376f844c7bdeeee7607a7c0ea8ae52061309b,2023-03-24 12:54:47+01:00,Normal,37859,37859,471002,471002,1934,1139.0,0,830,0,-257
cffcf0ef17b2dfd744d3bc64080229c1b500508f,659f6b5bc5d68661a071f0cd13b8dab678067023,2023-03-24 13:42:00+01:00,Normal,37859,37859,471002,471002,1934,1140.0,0,830,0,-257
f5c5c571d3b87a78d005ea6f21959388d1747696,cffcf0ef17b2dfd744d3bc64080229c1b500508f,2023-03-24 20:47:34+01:00,Normal,37859,37859,471019,471002,1934,1141.0,17,847,0,-257
3afdc9e9b47d5bdd1bd653633b4cb2357478ade5,fcc7dc5781667932bf0bf8bec76df458836e5e95,2023-03-28 19:18:48+02:00,Normal,37868,37868,471210,471200,1938,1142.0,10,857,0,-257
996c802229b93fe83c39842e56c6b8668464deaf,3afdc9e9b47d5bdd1bd653633b4cb2357478ade5,2023-03-28 21:03:24+02:00,Normal,37870,37868,471241,471210,1938,1143.0,31,888,2,-255
93faad78cc7eabc7c5e22a77c0481cd72f2e29f8,080e13a6ef9c896bba0f272c68d7d03696058955,2023-03-29 16:26:53+02:00,Normal,37875,37875,471260,471260,1939,1144.0,0,888,0,-255
b347dc63d5468564cbb7050461565f4f89032664,93faad78cc7eabc7c5e22a77c0481cd72f2e29f8,2023-03-29 20:06:49+02:00,Normal,37875,37875,471254,471260,1939,1145.0,-6,882,0,-255
7330408ac36f893a4a11c668ba230b440ec09f41,b347dc63d5468564cbb7050461565f4f89032664,2023-03-30 10:22:23+02:00,Normal,37832,37875,471169,471254,1940,1146.0,-85,797,-43,-298
56dadad7435af75d57a29699855d82b37434259a,066aabcb77579cf8d549119c860d11cd15e3eef1,2023-04-02 09:54:33+02:00,Normal,37825,37825,471164,471164,1943,1147.0,0,797,0,-298
982f904f4f0d14da20367da368169c8b4f2557c6,cbcc1240e912cfc47cb6ea0c4fe6b4a48f36f7e2,2023-04-03 08:40:06+02:00,Normal,37825,37825,473087,471163,1944,1148.0,1924,2721,0,-298
8adbab49e116c31619ca38061cb2e74a1a1ec85a,982f904f4f0d14da20367da368169c8b4f2557c6,2023-04-03 09:00:23+02:00,Normal,37825,37825,473087,473087,1944,1149.0,0,2721,0,-298
4e4eda6d6c8a5867dafd2ba9167ad8c064bb644a,8adbab49e116c31619ca38061cb2e74a1a1ec85a,2023-04-03 11:17:54+02:00,Normal,37825,37825,473087,473087,1944,1150.0,0,2721,0,-298
073b5fd40035759afaebe5c77de5269aee851643,1d1ddffc27cd55c011298cd09bfa4de3fa73cf7a,2023-04-04 07:27:34+02:00,Normal,37849,37849,473214,473214,1945,1151.0,0,2721,0,-298
fdf0a367bdd72c70f91fb3aed77dabbe9dcef69f,87c63bd8df0eb0109df333df1264c6a96707d6a4,2023-04-05 06:09:31+02:00,Normal,37849,37849,473249,473249,1946,1152.0,0,2721,0,-298
38e63c9e61152682f3ff982c85a73793ab6d3267,fdf0a367bdd72c70f91fb3aed77dabbe9dcef69f,2023-04-05 13:59:10+02:00,Normal,37849,37849,473254,473249,1946,1153.0,5,2726,0,-298
02a04ab79ae8c9e1aa10a91ee8b73fc5252a58e8,263db8af469f0f3a5bd8ddc4a7dd0154c3d1fbca,2023-04-06 13:32:47+02:00,Normal,37849,37849,473248,473254,1947,1154.0,-6,2720,0,-298
4bf4222010fd8e413963c6c873e4088614332ef9,02a04ab79ae8c9e1aa10a91ee8b73fc5252a58e8,2023-04-06 13:32:47+02:00,Normal,37849,37849,473251,473248,1947,1155.0,3,2723,0,-298
5b8a043bf51ab8bcf4a758d0b4646f30a84be183,73cbb372baa45d1fdafd571e2f430a980831f722,2023-04-07 10:11:41+02:00,Normal,37843,37858,473290,473278,1948,1156.0,12,2735,-15,-313
2eb1f37260f0e0b71ef3a77eb5522d2bb68d6489,5b8a043bf51ab8bcf4a758d0b4646f30a84be183,2023-04-07 11:07:54+02:00,Normal,37843,37843,473285,473290,1948,1157.0,-5,2730,0,-313
280ca147af9cdfce1ca9cb14cc3c5527ff6c7a02,dfc720c521062cdefd64bc48a11838b0fa583439,2023-04-12 18:52:43+02:00,Normal,37853,37853,473335,473357,1953,1158.0,-22,2708,0,-313
173034b00589c083793d495e8b07e35be2cb1cf0,280ca147af9cdfce1ca9cb14cc3c5527ff6c7a02,2023-04-12 18:52:43+02:00,Normal,37853,37853,473321,473335,1953,1159.0,-14,2694,0,-313
198a19b692699ad3940373d9ed797fe9155f3f4a,53aee470d5b35e2708864d5221d2b5655e10c091,2023-04-14 17:41:03+02:00,Normal,37878,37861,473371,473350,1955,1160.0,21,2715,17,-296
498195bda492d09ed00d05ab268cad4b8e5c9f21,0494efddc422716431b92896899284b6afebb23a,2023-04-20 12:24:33+02:00,Normal,37904,37904,473697,473697,1961,1161.0,0,2715,0,-296
765b96734c374ae8612720a6f71c0094430e6cf7,8a6c0203c4e92908c2b26ba54feba4ce7e76d081,2023-04-21 10:00:09+02:00,Normal,37904,37904,473764,473771,1962,1162.0,-7,2708,0,-296
c487634c106888effbba680e02269e489ab911a6,8ed25d65ea7546fafd808086fa07e7e5bb5428fc,2023-04-21 12:03:59+02:00,Normal,37904,37904,473802,473802,1962,1163.0,0,2708,0,-296
92537e83c1322c40dd39a8f0f9c78018307f2102,c487634c106888effbba680e02269e489ab911a6,2023-04-21 19:49:59+02:00,Normal,37904,37904,473797,473802,1962,1164.0,-5,2703,0,-296
9440f6ba41e5e96458cd7949fc6d605ef5bd09e9,453cfa28156f2c00cc45645421af4182aa863ff4,2023-04-26 08:36:56+02:00,Normal,37923,37917,473986,473980,1967,1165.0,6,2709,6,-290
18a7f2c711529f8e43c36190a5e2479f13899749,9440f6ba41e5e96458cd7949fc6d605ef5bd09e9,2023-04-26 08:47:44+02:00,Normal,37923,37923,473986,473986,1967,1166.0,0,2709,0,-290
720abed34304ec410c04a2e7a7dec7be4dae0d61,23d24f82a7450ef5d369845e18cc0130be5bac6c,2023-04-27 15:26:23+02:00,Normal,37926,37923,474011,473994,1968,1167.0,17,2726,3,-287
5a6d4d3bfde07daab9777545694beb014c832264,7bbbadc69383f0a2b99253e153b974f8783e876d,2023-04-28 13:04:08+02:00,Normal,37945,37945,474104,474104,1969,1168.0,0,2726,0,-287
191f6a9a4586b5e5f79f4f42f190e7ad4bbacc84,0b0998dc151feb77068e2387c34cc50ef6b356ae,2023-05-01 18:57:24+02:00,Normal,37945,37945,474135,474116,1972,1169.0,19,2745,0,-287
0e444e84f87d174713a2aef0c4f9704ce2865586,191f6a9a4586b5e5f79f4f42f190e7ad4bbacc84,2023-05-02 06:04:18+02:00,Normal,37932,37945,474139,474135,1973,1170.0,4,2749,-13,-300
83339d2103f447377fedb3bd145b52c3ef2b667c,ea53e7c09f1b8864c20c65976bbeaeab77abdaec,2023-05-03 07:58:42+02:00,Normal,37948,37948,474168,474171,1974,1171.0,-3,2746,0,-300
8e2460d599aec95f8cfe514d3cc8acdd4ca4b1fb,83339d2103f447377fedb3bd145b52c3ef2b667c,2023-05-03 13:06:19+02:00,Normal,37961,37948,474420,474168,1974,1172.0,252,2998,13,-287
fb4c55d9ec4bb812a7fb91fa20510d91645e411b,8e2460d599aec95f8cfe514d3cc8acdd4ca4b1fb,2023-05-03 13:42:00+02:00,Normal,37967,37961,474559,474420,1974,1173.0,139,3137,6,-281
b0d3a5de95c9966075c38f10e790dced70c81ebf,fb4c55d9ec4bb812a7fb91fa20510d91645e411b,2023-05-03 15:13:07+02:00,Normal,37967,37967,474559,474559,1974,1174.0,0,3137,0,-281
49830025c992fbc8d8f213e7c16dba1391c6adf2,b0d3a5de95c9966075c38f10e790dced70c81ebf,2023-05-03 15:20:31+02:00,Normal,37967,37967,474559,474559,1974,1175.0,0,3137,0,-281
fcfbf08abe3e6dc54894df6988024f055abc6c40,f5b39b77e38b7585861df9314aba4ce93b018c4c,2023-05-04 08:09:02+02:00,Normal,37969,37969,474587,474578,1975,1176.0,9,3146,0,-281
ca5d3c99efb1bcf181e923dcd00c4679ab6174ef,024954aad4c422a091b7afab42fff1a9d7478fce,2023-05-05 09:26:51+02:00,Normal,37969,37969,474583,474582,1976,1177.0,1,3147,0,-281
1586a09b7949bbb7b0d84cb74ce1cadc25cbb355,aaf8c76c567e8311f4a85cf74c82fc3d70cc6f12,2023-05-08 19:34:30+02:00,Normal,37969,37969,474579,474583,1979,1178.0,-4,3143,0,-281
59262c294d26d2aa9346284519545c0f988bf353,1586a09b7949bbb7b0d84cb74ce1cadc25cbb355,2023-05-09 11:39:49+02:00,Normal,37969,37969,474578,474579,1980,1179.0,-1,3142,0,-281
6e32d1fa1dafd0c9cd9f93997ecebb26cd9a1b62,c494c6974dd0e7c5a43ea3e220b34641abc3ba29,2023-05-10 17:22:45+02:00,Normal,37975,37969,474642,474638,1981,1180.0,4,3146,6,-275
72a86ceb33749d4fd17d3d2910e19b9d9ca1643b,2b11740e1d9d23ef53d94a1c45896fb7b91df908,2023-05-11 18:22:55+02:00,Normal,37960,37960,474659,474641,1982,1181.0,18,3164,0,-275
93830abf7694e0f281931f10eeaa34993855e7dd,99e5dff737cd20b12d060e4794e097063b61ec40,2023-05-17 12:13:10+02:00,Normal,38033,38033,475677,475677,1988,1182.0,0,3164,0,-275
c52f4295f254e1c14af769d22b1a5f516a941f58,93830abf7694e0f281931f10eeaa34993855e7dd,2023-05-17 13:14:43+02:00,Normal,38038,38033,475702,475677,1988,1183.0,25,3189,5,-270
fc9c90d9c4611d441d2617a7d74f622b1f520f7c,23abec9192c88f9372e5784ae69c9aa5be2b21be,2023-05-23 12:56:33+02:00,Normal,38061,38061,476092,476087,1994,1184.0,5,3194,0,-270
d3d173425fc0a1107836da5b4567f1c88253191b,881cc139e2d53cc1d3ccea7f38faa960f9e56597,2023-05-26 12:16:26+02:00,Normal,38058,38061,476106,476110,1997,1185.0,-4,3190,-3,-273
1136aa5005f0ae70fea12796b7e37d6f027b9263,7d96ce68ae2c1bab1f2ab64ddc2b2c6004278af0,2023-06-03 12:01:15+02:00,Normal,38062,38062,476197,476197,2005,1186.0,0,3190,0,-273
f9936deed1ff13b20e18bd9ca2b0750b52706b6c,1136aa5005f0ae70fea12796b7e37d6f027b9263,2023-06-04 20:49:07+02:00,Normal,38062,38062,476221,476197,2006,1187.0,24,3214,0,-273
40a2c811e3ed7fdb26ab4443e39e113c2fcf2aa9,51fdea68415c580cd753990e3238ae2e0f015263,2023-06-06 07:33:59+02:00,Normal,38068,38068,476324,476318,2008,1188.0,6,3220,0,-273
4f6a51dfe6a4a8d5ed61c73b902e808109f142b0,40a2c811e3ed7fdb26ab4443e39e113c2fcf2aa9,2023-06-06 11:38:23+02:00,Normal,38068,38068,476323,476324,2008,1189.0,-1,3219,0,-273
caf80cb41f13e84803a94928282cae75333bbdfc,531f557f9238b8f2e5032e569cf36f0c05bb4043,2023-06-09 21:37:23+02:00,Normal,38076,38076,476490,476466,2011,1190.0,24,3243,0,-273
06881341d48dd17a4fdf25afc96991de4fb3b1ac,decbfa834ff2c981f945934e0037edfcfdae3bf8,2023-06-13 10:12:52+02:00,Normal,38075,38075,476558,476558,2015,1191.0,0,3243,0,-273
c1cff3c4715f633b5123d32227af5104f8585fc7,1fe0b167af3611cca79e8a8092ee929312193c6f,2023-06-16 12:20:13+02:00,Normal,38081,38081,476718,476714,2018,1192.0,4,3247,0,-273
17cdc7395ed4606bfcbd3bebcaae66a0b5d88188,8b062eab8edeb3206d31437ea00f96a9d6237291,2023-06-18 13:20:05+02:00,Normal,38081,38081,476840,476840,2020,1193.0,0,3247,0,-273
ddb6506618ea52c6b20e97eefad03ed847a1e3de,1754c2c8026ab592183821c3933972a8aa7acc66,2023-06-20 12:59:32+02:00,Normal,38090,38090,476953,476953,2022,1194.0,0,3247,0,-273
650ce967825aa192222391bfe3003c8d97e6f1d0,6523860ca8c7127f850f2fbc24afb6ea63b76949,2023-06-23 21:52:04+02:00,Normal,38264,38264,477254,477254,2025,1195.0,0,3247,0,-273
865a6650d0739e857fb605767afebdce4f8c54c3,fcc5091b4a7c29e2912f6c8b2e0ebc64f4853457,2023-06-26 09:29:01+02:00,Normal,38244,38244,477260,477260,2028,1196.0,0,3247,0,-273
370a021780b25123a410ffa771ed7d88b8760570,3152f9de47a317d658ebee6d5b517b7e1258aa1f,2023-06-26 14:22:54+02:00,Normal,38277,38277,477435,477435,2028,1197.0,0,3247,0,-273
2360ba22742c3ee8729697bfe2d508110465af56,ecd5a0daaf7bda6154175df2280f888099deefe8,2023-06-26 14:35:13+02:00,Normal,38277,38277,477436,477436,2028,1198.0,0,3247,0,-273
c4a09499aa760c92969083b4639703b5b0a562fb,5e98959d9242c57a55c65847758781f82d386fa4,2023-06-27 12:54:11+02:00,Normal,38285,38285,477657,477657,2029,1199.0,0,3247,0,-273
a6d30f50125782db6643d4b24ff30d88adf13cbe,c4a09499aa760c92969083b4639703b5b0a562fb,2023-06-27 13:50:42+02:00,Normal,38285,38285,477731,477657,2029,1200.0,74,3321,0,-273
21e686471598d6c755d93a570de20dc00d8d27f6,1dbcf9a005842c3fdd97537f1bd4fab5b96b972f,2023-06-28 12:11:25+02:00,Normal,38285,38285,477733,477733,2030,1201.0,0,3321,0,-273
6a523500af5bab3e05d9be9fc1a74d986c102f1a,7af455a402bf383575a494243e766d6247fd86a3,2023-06-29 09:11:30+02:00,Normal,38285,38285,477745,477750,2031,1202.0,-5,3316,0,-273
601ffb0da3a8c3900164b356c585650c00d238b0,ce204bed7f59e34a9ec226e1699db257ec33da30,2023-06-29 21:45:36+02:00,Normal,38285,38285,477750,477789,2031,1203.0,-39,3277,0,-273
953f29f700a60fc09b08b2c2270c12c447490c6a,a40b0103bccb8216c944188d329d8ea5eceb7e92,2023-06-30 06:03:08+02:00,Normal,38286,38286,477872,477862,2032,1204.0,10,3287,0,-273
7eeadc82c2f7d7a778e3bb43c34d642e6275dacf,5820fc44854e421e4ebaaddb34d7109ff15e1148,2023-06-30 10:18:04+02:00,Normal,38286,38286,477886,477884,2032,1205.0,2,3289,0,-273
ad0410ec4f458aa39803e5f6b9a3736527062dcd,7eeadc82c2f7d7a778e3bb43c34d642e6275dacf,2023-07-03 08:16:55+02:00,Normal,38287,38286,477899,477886,2035,1206.0,13,3302,1,-272
1d6fbf16f24200a556beb6dd197439944deb6837,ad0410ec4f458aa39803e5f6b9a3736527062dcd,2023-07-03 10:19:13+02:00,Normal,38287,38287,477899,477899,2035,1207.0,0,3302,0,-272
393b8324b390aef428016f93b3cb30228d38dc87,1d6fbf16f24200a556beb6dd197439944deb6837,2023-07-03 10:33:50+02:00,Normal,38287,38287,477899,477899,2035,1208.0,0,3302,0,-272
42b4f81e6efd5c4587e1207a2ae3dd0facb1436f,968684aed492e03b137e6330bec507adffb074d2,2023-07-04 13:34:08+02:00,Normal,38287,38287,477915,477904,2036,1209.0,11,3313,0,-272
95cdf9dc6627135f3893095892816eb3f2785e2e,966ecdd482167f3f6b08b00f484936c837751cb9,2023-07-06 11:29:16+02:00,Normal,38289,38289,477997,477998,2038,1210.0,-1,3312,0,-272
f64fd47a7627ed6ffe2df2a32ded6ee528a784eb,d569c1dcfeb26ca9ee391e5dfeadedf2b5ed4253,2023-07-07 08:06:01+02:00,Normal,38290,38289,478032,477984,2039,1211.0,48,3360,1,-271
2584783f46922bcb456ceb9700a3726314df65d3,eed096574fea5c9d82d0dc5952ad439dfde13718,2023-07-07 13:22:06+02:00,Normal,38292,38292,478061,478062,2039,1212.0,-1,3359,0,-271
99bd373367e54790da25b64c1d21610ac0f9feda,953f81e078fb7299b6d40d4e599e5f559e03952b,2023-07-10 09:29:42+02:00,Normal,38290,38290,477932,477932,2042,1213.0,0,3359,0,-271
fb1c7635065321d415ad8182caf986a824bf9650,f7cfa48283c94018861688f17ab3935d588fbcc3,2023-07-10 11:21:59+02:00,Normal,38294,38294,477958,477970,2042,1214.0,-12,3347,0,-271
5a2e11fd31950336ea996ce5240fd16f4f3c3614,89c7454dbdae3e0df6d96aa6132205d05e4a9b3d,2023-07-11 08:06:49+02:00,Normal,38294,38294,478066,478066,2043,1215.0,0,3347,0,-271
c7276a9cb97e8581faccb6c66a6a490e2d400c07,5a2e11fd31950336ea996ce5240fd16f4f3c3614,2023-07-11 10:46:34+02:00,Normal,38294,38294,478078,478066,2043,1216.0,12,3359,0,-271
e5e9699e0fe1e7affe3c68082ed1e205726a4c79,7f2bc365b3652eaa8a8c19e58ddd35f062c68dbc,2023-07-11 22:45:31+02:00,Normal,38304,38311,478155,478164,2044,1217.0,-9,3350,-7,-278
4afaeb14c293725d7b2530788083fce1c120ff65,503ce7f1b791fd23d1fccc1970ba83ec55532a1c,2023-07-12 11:06:59+02:00,Normal,38304,38304,478143,478169,2044,1218.0,-26,3324,0,-278
da2f8e8257d1bea4215381684ca4abfcee333c43,0016a4299569a8f09ff24053ff2b8224f7fa4113,2023-07-17 11:03:36+02:00,Normal,38310,38304,478201,478198,2049,1219.0,3,3327,6,-272
3109038992321e471944bd8ee36670c9e6b8ff0c,6ad2738a8f32b94cbae742f212080fadf2dee421,2023-07-18 14:08:47+02:00,Normal,38312,38312,478229,478215,2050,1220.0,14,3341,0,-272
02376f1f53db24039c200ef4818d96accf16a88b,e4a5527d1dc2f8183883931560f3a6dcdef0ab0c,2023-07-21 12:54:38+02:00,Normal,38325,38325,478553,478553,2053,1221.0,0,3341,0,-272
22b0b73c7732ba67db4e69fd9fa75aad84c8e5c4,4087367ba869be9cf305dac39a8887d4aa4041d2,2023-07-30 16:17:07+02:00,Normal,38333,38333,479097,479097,2062,1222.0,0,3341,0,-272
c9b9a52edc66be117c6e5b5214fa788a4d5db7a8,5a3725594faacc412e2d2b4ed160370228f1a118,2023-08-01 16:16:28+02:00,Normal,38341,38332,479204,479158,2064,1223.0,46,3387,9,-263
9b9c805cedb08621bd5dc58a01a6478eb7cc49a9,7cd187a5ba58d7769039f487faeb9a5a2ff05540,2023-08-02 19:53:16+02:00,Normal,38361,38361,479243,479243,2065,1224.0,0,3387,0,-263
b719688b21febd9a04c8623126558cd06cc27b80,b3e0170ab546a96930ce3114b0a1a560953c0ff4,2023-08-03 18:54:29+02:00,Normal,38361,38361,479223,479255,2066,1225.0,-32,3355,0,-263
4555a823fd57e261e1b19c778429473256c8ea08,b719688b21febd9a04c8623126558cd06cc27b80,2023-08-03 19:44:36+02:00,Normal,38361,38361,479219,479223,2066,1226.0,-4,3351,0,-263
2b582387d51c44fa928351ca55f05fc8b8d2986e,f46a6b2816819ed12d4d0150c99d66920070ca15,2023-08-04 06:35:13+02:00,Normal,38361,38361,479061,479245,2067,1227.0,-184,3167,0,-263
0336aa6672ea91a30ff5ab12b655c0ee6a00fa73,3434dbd39d373df7193ad006b970c09c1a909ea3,2023-08-04 17:36:04+02:00,Normal,38361,38361,479095,479093,2067,1228.0,2,3169,0,-263
80a5667c50d12b27a031a9ce0408a5b81bc4e684,439242c5943e16dd5a3a68fadac76e5e723eb323,2023-08-09 12:41:47+02:00,Normal,38403,38403,479290,479313,2072,1229.0,-23,3146,0,-263
e69a9920e2b69d9b765a81d9ebeedfdc938892f6,80a5667c50d12b27a031a9ce0408a5b81bc4e684,2023-08-10 05:33:13+02:00,Normal,38403,38403,479290,479290,2073,1230.0,0,3146,0,-263
59f13ce5453af56300669a47fb2227fb212d587a,e69a9920e2b69d9b765a81d9ebeedfdc938892f6,2023-08-10 08:59:29+02:00,Normal,38403,38403,479293,479290,2073,1231.0,3,3149,0,-263
6b965c600054f970bdf94017ecf2e0e6e0a4326b,d25f3892114466d689fd6936f79f3bd9a9acc30e,2023-08-18 18:11:24+02:00,Normal,38427,38406,479581,479464,2081,1232.0,117,3266,21,-242
4c85d94bc04b7c1d5d0af42c00dcea986d6ecbb2,517d3bb4dd17e9c51690c98d747b86a0ed8b2fbf,2023-08-20 16:09:07+02:00,Normal,38427,38427,479588,479587,2083,1233.0,1,3267,0,-242
bd2ff65fddd0259e37996e904c90ccf49c2cbb9f,4c85d94bc04b7c1d5d0af42c00dcea986d6ecbb2,2023-08-20 21:53:40+02:00,Normal,38429,38427,479588,479588,2083,1234.0,0,3267,2,-240
dd45d5223b3c5640baefcb591782bbcff873b6bf,a9e0f3d3014461c2199123721899162c0876959d,2023-08-23 09:09:23+02:00,Normal,38423,38423,479850,479827,2086,1235.0,23,3290,0,-240
9942a3e49b801b59e10329d86cd8bf12f1716529,c59be9f1da7e1fc58df49d5eda4e80cd50ce5710,2023-08-24 05:19:52+02:00,Normal,38423,38423,479948,479948,2087,1236.0,0,3290,0,-240
95b844915822daa41247ae56d2ccd5cf36c881e1,9942a3e49b801b59e10329d86cd8bf12f1716529,2023-08-24 10:31:52+02:00,Normal,38423,38423,479948,479948,2087,1237.0,0,3290,0,-240
9c37103a98d030be110eb9ba8b7ed32a47240b28,b7fe36ad37fb18c4bc7932c0aec6ae4f299b9622,2023-08-25 11:24:21+02:00,Normal,38421,38421,479978,479978,2088,1238.0,0,3290,0,-240
11920e77959deaa65eb86ccc5d39da903fd3dd41,9c37103a98d030be110eb9ba8b7ed32a47240b28,2023-08-25 21:27:22+02:00,Normal,38431,38421,480018,479978,2088,1239.0,40,3330,10,-230
24f1a38b37c0af3a5ce0dd7b5392fe4e75d7e1dc,11920e77959deaa65eb86ccc5d39da903fd3dd41,2023-08-28 06:10:20+02:00,Normal,38431,38431,480018,480018,2091,1240.0,0,3330,0,-230
c74a6fad5475495756a5bdb18b2cab2b68d429bc,4c4536f7442a3ed1218f5b1dc791295d65c24f4c,2023-08-31 10:27:32+02:00,Normal,38579,38579,481118,481118,2094,1241.0,0,3330,0,-230
048d75aeb1e2b1c08b1b9ec359397f00aec1b57d,bcd80de8b5264d8c853bbd38bfeb02279a9b3799,2023-09-03 10:11:15+02:00,Normal,38579,38579,481179,481173,2097,1242.0,6,3336,0,-230
3f41d6d62929dfe53eda8109b3b836f26645bdce,048d75aeb1e2b1c08b1b9ec359397f00aec1b57d,2023-09-04 11:58:37+02:00,Normal,38579,38579,481200,481179,2098,1243.0,21,3357,0,-230
8a98768868a104ea3ce10d8182590bdd095d9ccb,3f41d6d62929dfe53eda8109b3b836f26645bdce,2023-09-04 13:09:48+02:00,Normal,38579,38579,481200,481200,2098,1244.0,0,3357,0,-230
a534835c7b4cf1556638edd39acde7b2b88c8892,8a98768868a104ea3ce10d8182590bdd095d9ccb,2023-09-04 13:22:22+02:00,Normal,38579,38579,481200,481200,2098,1245.0,0,3357,0,-230
4f0c0e6fa1ce2e4da9407f122d0c1c27c7f8ad83,6c6606aa014862f1a5c112d688d5e91c0cd9a8d8,2023-09-05 10:52:17+02:00,Normal,38579,38579,481196,481196,2099,1246.0,0,3357,0,-230
ecb6085f6fdb6319656b54cc92e6a91c1df47f23,71820c9f91a70076526e2f526236fc4172d92fea,2023-09-10 10:07:22+02:00,Normal,38644,38644,482132,482132,2104,1247.0,0,3357,0,-230
a7c73b944f51d6c92ec876fd7e0a171e7c01657d,938170008ea48dff8f89b0839998a1eec939ddf4,2023-09-11 13:04:32+02:00,Normal,38650,38650,482196,482182,2105,1248.0,14,3371,0,-230
0e540fca13ecf3d40be374ef7be94a0357222873,74f7deec9e334a69bfbfdd068285618534198bd5,2023-09-13 13:49:01+02:00,Normal,38717,38715,482677,482677,2107,1249.0,0,3371,2,-228
e2a3a896cf0825a2da2347773c79ba7a341fe392,691f70c47755c7f55fa75ce607d028f81468b745,2023-09-14 19:49:06+02:00,Normal,38720,38720,482746,482746,2108,1250.0,0,3371,0,-228
88b5b7b8e56667b0f55ea6f04038b6ac77c57b98,814e7bc22062eeae4be9f189e89027e28d5dd290,2023-09-16 06:57:38+02:00,Normal,38726,38726,482804,482804,2110,1251.0,0,3371,0,-228
190874eadd0c6dcaae0c244cc47e838cf0faf24d,225328efd9814f2e922ee77fb48a3eea7428c397,2023-09-18 08:54:44+02:00,Normal,38733,38733,482845,482845,2112,1252.0,0,3371,0,-228
caf87b4d4278602812fd3bb8b0d78dfca18db28d,f72f420f17c1bf6aea4022ecdb9b5f53a46597cc,2023-09-18 22:12:40+02:00,Normal,38555,38555,480609,480614,2113,1253.0,-5,3366,0,-228
f72f420f17c1bf6aea4022ecdb9b5f53a46597cc,3a3e737694b89e29308e54f12faaa375226b7060,2023-09-18 22:12:40+02:00,Normal,38555,38618,480614,481081,2113,1254.0,-467,2899,-63,-291
3a3e737694b89e29308e54f12faaa375226b7060,5e4c1793b714a975400b9277a66f99efafa2d92c,2023-09-18 22:12:40+02:00,Normal,38618,38618,481081,481127,2113,1255.0,-46,2853,0,-291
c35fd9e2750a3e49a57d9fef964b9ef3e7cb49cb,7433237664e9a942d6584b4e70fd6a5174cf8f39,2023-09-18 22:12:40+02:00,Normal,38646,38668,481284,481302,2113,1256.0,-18,2835,-22,-313
69af3bea9987044c944b5bc83e32c35f0a73c6dd,c35fd9e2750a3e49a57d9fef964b9ef3e7cb49cb,2023-09-18 22:12:40+02:00,Normal,38626,38646,481262,481284,2113,1257.0,-22,2813,-20,-333
0e560edf32c001705dd43bdc68099d271c20c312,caf87b4d4278602812fd3bb8b0d78dfca18db28d,2023-09-18 22:12:40+02:00,Normal,38555,38555,480609,480609,2113,1258.0,0,2813,0,-333
7433237664e9a942d6584b4e70fd6a5174cf8f39,04eb1b4567c96ccb167c16a95ca12c336b0c791b,2023-09-18 22:12:40+02:00,Normal,38668,38668,481302,481342,2113,1259.0,-40,2773,0,-333
5e4c1793b714a975400b9277a66f99efafa2d92c,69af3bea9987044c944b5bc83e32c35f0a73c6dd,2023-09-18 22:12:40+02:00,Normal,38618,38626,481127,481262,2113,1260.0,-135,2638,-8,-341
6e4e5523a8f40b63f3e74889266a7d638f6364dc,14ef92fa9e87a77cd3642235387e6f683048046b,2023-09-18 22:12:40+02:00,Normal,38673,38721,481528,481802,2113,1261.0,-274,2364,-48,-389
b9a25b69ae93dcd3c4971cdeb5dabd3fb710de15,613b7ba212d773e8b8a4ecb8236ef575c153a9a6,2023-09-18 22:12:40+02:00,Normal,38771,38771,483228,483228,2113,1262.0,0,2364,0,-389
590a31eb105292510ce94adebc85d691b30f49ca,b9a25b69ae93dcd3c4971cdeb5dabd3fb710de15,2023-09-18 22:12:40+02:00,Normal,38771,38771,483228,483228,2113,1263.0,0,2364,0,-389
295467c04ab4c26a1a9d3798b1e941003fa116cf,590a31eb105292510ce94adebc85d691b30f49ca,2023-09-18 22:12:40+02:00,Normal,38771,38771,483228,483228,2113,1264.0,0,2364,0,-389
04eb1b4567c96ccb167c16a95ca12c336b0c791b,6e4e5523a8f40b63f3e74889266a7d638f6364dc,2023-09-18 22:12:40+02:00,Normal,38668,38673,481342,481528,2113,1265.0,-186,2178,-5,-394
2abf417c815c20f41c0868d6f66520b32347106e,00e187961059a0e77403151d2bb38c217101d5af,2023-09-18 22:12:40+02:00,Normal,38727,38771,481949,483194,2113,1266.0,-1245,933,-44,-438
14ef92fa9e87a77cd3642235387e6f683048046b,2abf417c815c20f41c0868d6f66520b32347106e,2023-09-18 22:12:40+02:00,Normal,38721,38727,481802,481949,2113,1267.0,-147,786,-6,-444
00e187961059a0e77403151d2bb38c217101d5af,295467c04ab4c26a1a9d3798b1e941003fa116cf,2023-09-18 22:12:40+02:00,Normal,38771,38771,483194,483228,2113,1268.0,-34,752,0,-444
8af3ae4ad9ca475f2428fac950de8df56b575e6a,23df37d53a6d7010f43920cb1202bc5254449601,2023-09-19 08:09:03+02:00,Normal,38555,38555,480610,480607,2113,1269.0,3,755,0,-444
909f8e4c24e5c0c2fcf3f6bab2f87c0735bcc832,8af3ae4ad9ca475f2428fac950de8df56b575e6a,2023-09-19 09:27:28+02:00,Normal,38555,38555,480610,480610,2113,1270.0,0,755,0,-444
7c1cf585e80114b6e531b40bd2954406d033afe3,909f8e4c24e5c0c2fcf3f6bab2f87c0735bcc832,2023-09-19 08:21:22-03:00,Normal,38555,38555,480610,480610,2113,1271.0,0,755,0,-444
3623a0c0798f941da4d951c912b2c9057c1a3fd3,7c1cf585e80114b6e531b40bd2954406d033afe3,2023-09-19 15:06:05+02:00,Normal,38555,38555,480586,480610,2113,1272.0,-24,731,0,-444
2c6ebb65c9eb6b11347d907127b82d31e04569e5,0b506bfe1ab9f1c38e439c77b3c3f81c8ac663ea,2023-09-20 13:45:51+02:00,Normal,38555,38555,480564,480589,2114,1273.0,-25,706,0,-444
cfe27544dfa762a5cdebcdbfe749c0ee55d0393d,2c6ebb65c9eb6b11347d907127b82d31e04569e5,2023-09-21 08:10:51+02:00,Normal,38555,38555,480564,480564,2115,1274.0,0,706,0,-444
779cd28acb1f7eb06f629c0ea4ded99b5ebb670a,78b5c9075348aa12da2e024f6ece29d1d652dfdd,2023-09-22 06:01:11+02:00,Normal,38555,38555,480620,480564,2116,1275.0,56,762,0,-444
f9e9526800c921ae393ff58826daed51587b1727,357365a64e1c756eabaaf0ee0404df87c15c6e9b,2023-09-26 12:05:26+02:00,Normal,38578,38578,480745,480738,2120,1276.0,7,769,0,-444
571bab98879578b6ef54ee654ead06736855767d,f9e9526800c921ae393ff58826daed51587b1727,2023-09-27 19:09:10+02:00,Normal,38578,38578,480745,480745,2121,1277.0,0,769,0,-444
6ad0dbc8d90ef37731608f7ac3d6e1d62cc8c765,fe835c2355072fc2b7a0fbbc57d05477c7ee6ce9,2023-09-29 08:54:13+02:00,Normal,38580,38580,480786,480785,2123,1278.0,1,770,0,-444
679212a47ac3e22a6fbb6ee3cd4c09f29aae8b5d,35bbb2c9c01882b1d77b0b8c737ac646144833d4,2023-10-03 09:25:48+02:00,Normal,38586,38580,480843,480817,2127,1279.0,26,796,6,-438
54d9d26ebfc90711430a79219d6547141ce1717f,679212a47ac3e22a6fbb6ee3cd4c09f29aae8b5d,2023-10-03 10:25:31+02:00,Normal,38586,38586,480843,480843,2127,1280.0,0,796,0,-438
f9cdecfb0de40698eb2ce44c04068bb091fa8998,4e790271e3e65c9ad037b347a34fa95e11982228,2023-10-04 19:53:15+02:00,Normal,38596,38596,480986,480986,2128,1281.0,0,796,0,-438
91cb2d0b487acc56d886612a7251b9ba555d71b4,ea596a52d9f905596cc5335930c8f2ac4511204c,2023-10-05 15:26:02+02:00,Normal,38596,38596,481003,481003,2129,1282.0,0,796,0,-438
296b75a3c0309a936a6c07d8f711f722e3b96e63,90c75dc4f37bee19b7c3790519d187e38e293800,2023-10-06 20:18:41+02:00,Normal,38598,38596,481062,481021,2130,1283.0,41,837,2,-436
54b23b1835a8044c35754525dfcf2c3027d79aa8,958e4cfe42190539af9386e753d59cd487bd8847,2023-10-09 09:55:52+02:00,Normal,38598,38598,481062,481062,2133,1284.0,0,837,0,-436
6e369f36f2def929525e524f621eead4b041d1cf,d21ab70223dcbdc5a2603a88945147f2f780deee,2023-10-11 10:58:10+02:00,Normal,38598,38598,481062,481062,2135,1285.0,0,837,0,-436
9fd3a0ffc8fb8e532b0d5717f99fb15aff175a6c,8adc7c86ab85ed91e512bc49056e301cbe1715d0,2023-10-12 20:01:44+02:00,Normal,38600,38600,481154,481153,2136,1286.0,1,838,0,-436
20b7aac7ca60b0352d926340622e618bcbee54a8,3b4a571275d967512866012955eb0b3ae486d63c,2023-10-16 06:27:27+02:00,Normal,38602,38602,481185,481182,2140,1287.0,3,841,0,-436
86ae1a3b6c5e881d9e81a92918a6e0c9a7f097b8,3b255d72cf73e89ac1dc94d74467e5e4c487f5f2,2023-10-19 13:37:05+02:00,Normal,38602,38602,481283,481283,2143,1288.0,0,841,0,-436
7fcf4f2f0f19c353fe3ee9fe2f6c4baeda4f03c8,68d0159b6dfce07f144045d56639c52066e8b90e,2023-10-23 08:58:30+02:00,Normal,38608,38608,481341,481341,2147,1289.0,0,841,0,-436
311718feb5f1fb9ff794bbac0cda48cfc3410de8,d22ba0763086f71fb6df8502162ea63944d166b1,2023-10-24 14:09:31-03:00,Normal,38632,38632,481532,481509,2148,1290.0,23,864,0,-436
fdd1323b9c83e56184e0c992af8faf8d54327775,311718feb5f1fb9ff794bbac0cda48cfc3410de8,2023-10-25 05:37:57+02:00,Normal,38632,38632,481532,481532,2149,1291.0,0,864,0,-436
718b32c6918037cfc746d7867333d79a3c887a8c,ee104251c403fbac83b8475163ff2ac01c567d25,2023-10-25 12:27:27+02:00,Normal,38640,38640,481546,481546,2149,1292.0,0,864,0,-436
cf57e220a952f4f9cd45f91a5679089f71a255f0,c42250a7039a5ace1b482b30c6a1359b748cae65,2023-10-27 09:05:09+02:00,Normal,38640,38640,481688,481688,2151,1293.0,0,864,0,-436
46df3ab244e1688bd186f0bfbfea6a354097a910,6375cee490725969b4f67b3c988ef01350c1ad6d,2023-10-30 05:16:40+01:00,Normal,38640,38640,481803,481803,2154,1294.0,0,864,0,-436
05ba4130ee878c4f520b5d34bb11eaad794623be,40b3975e7d3e1464a733c69171ad7d38f8814280,2023-11-01 06:10:30+01:00,Normal,38639,38639,482536,482521,2156,1295.0,15,879,0,-436
7caf2621833a45cdfe7e6e305e4885ecc8d79744,05ba4130ee878c4f520b5d34bb11eaad794623be,2023-11-01 08:16:14+01:00,Normal,38639,38639,482536,482536,2156,1296.0,0,879,0,-436
36173cf29d6ad0b0f0cd24326834dddfff2db7f3,7caf2621833a45cdfe7e6e305e4885ecc8d79744,2023-11-01 08:22:47+01:00,Normal,38639,38639,482536,482536,2156,1297.0,0,879,0,-436
7a09ba0962e0eaf4ad396475b392ba3234bf60ee,797957fb48f63760442d3d4c8985fd94f8602d5e,2023-11-03 05:29:06+01:00,Normal,38639,38639,482625,482623,2158,1298.0,2,881,0,-436
656192c2c96bb955a399d92f381e38fe2254fe17,7a09ba0962e0eaf4ad396475b392ba3234bf60ee,2023-11-03 16:28:04+01:00,Normal,38639,38639,482620,482625,2158,1299.0,-5,876,0,-436
de4884b114534f43c49cf8c5b7f10181e737f4e9,6364b6ee1071381eb3a23ba6b821fc0d6f0fce75,2023-11-14 15:45:43+01:00,Normal,38721,38721,482786,482804,2169,1300.0,-18,858,0,-436
5875f03ce61b85dfd9ad34f7b871c231c358d432,de4884b114534f43c49cf8c5b7f10181e737f4e9,2023-11-14 20:22:07+01:00,Normal,38721,38721,482880,482786,2169,1301.0,94,952,0,-436
c705625ebff0141ed2b95dd3c8174bda8270a47f,5875f03ce61b85dfd9ad34f7b871c231c358d432,2023-11-14 20:22:07+01:00,Normal,38721,38721,482992,482880,2169,1302.0,112,1064,0,-436
